Xoc, Xoc, Xoc, Xoc, Xoc, Xoc, Xoc, Xoc, Xoc, Xoc, Xoc, Xoc
Xoc, Xoc, Xoc, Xoc, Xoc, Xoc, Rr, Xoc, Xoc, Xoc, Xoc, Xoc
Xoc, Xoc, Xoc, Xoc, Xoc, Rr^Es, Rr^Ecf, Rr, Rr^Edb, Xoc^Efs, Xoc, Xoc
Xoc, Xoc, Xoc, Xoc, Xoc, Rr^Es, Rr, Rr, Rr^Edb, Rr^Edt, Rr, Xoc
Icr, Xoc, Xoc, Xoc, Xoc, Rr^Pr\, Rr^Pr\, Rr^Edb, Rr^Edb, Rr, Rr, Xoc
Xoc, Icr, Icr, Xoc, Xoc^Efs, Irs, Irs, Rr^Pr\, Rr^Pr\, Rr, Rr^Em, Xoc
Xoc, Xoc, Xoc, Rr^Pw/, Irs, Irs, Irs^Efm, Irs, Irs, Rr^Pr\o, Rr^Pr\, Xoc
Xoc, Xoc, Irs^Ebn, Irs, Irs, Irs, Irs, Irs, Irs, Irs, Irs, Xoc
Xoc, Irs, Irs, Irs, Irs, Irs, Irs, Irs, Irs, Irs^Eb, Irs, Xoc
Xoc, Irs, Irs, Irs, Irs, Irs, Irs, Irs, Irs, Irs, Irs, Xoc
