Md^Xm, Mm, Mm, Mm, Gs^Fms, Mm, Md^Xm, Md^Xm, Ww^Ewl, Ww^Ewl, Hh, Mm, Mm, Mm, Wo, Wo, Wo, Wo, Wo, Wo, Mm, Md^Xm, Md^Xm, Ww
Mm, Mm, Mm, Gs^Fms, Gg, Mm, Ww, Ww^Ewl, Mm, Mm, Hh, Mm, Mm, Mm, Hh, Wo, Wo, Wo, Wo, Wo, Md^Xm, Mm, Wo^Es, Wwr
Mm, Mm, Hh, Hh^Vhh, Gg, Ww, Ww, Mm, Mm, Mm, Mm, Mm, Mm, Mm, Mm, Gs^Fms, Gs^Fms, Wo, Wo, Wo, Wo, Wo, Gg, Gg
Mm, Md^Xm, Hh, Gg, Ww, Ww, Mm, Mm, Mm, Mm, Hh, Hh, Mm, Mm, Mm, Mm, Mm, Gg, Hh, Wo, Wo, Gs^Fms, Gs^Fms, Hh
Gg, Gg, Gg, Mm, Ww, Ww, Mm, Mm, Mm, Hh, Mm, Mm, Mm, Hh, Hh, Mm, Hh, Mm, Hh, Mm, Ww^Es, Gg, Mm, Hh
Ww, Wwr, Ww^Es, Ww, Mm, Mm, Mm, Mm, Hh, Mm, Mm, Mm, Hh, Mm, Mm, Hh, Hh, Hh, Mm, Wwr, Ww^Es, Mm, Md^Xm, Mm
Ww, Ww^Es, Mm, Mm, Mm, Mm, Mm, Mm, Mm, Mm, Cte, Hh, Cte, Cte, Rp, Hh^Vhh, Hh, Mm, Mm, Ww^Es, Mm, Md^Xm, Md^Xm, Md^Xm
Mm, Mm, Mm, Mm, Mm, Md^Xm, Mm, Mm, Mm, Hh, Cte, Rp, Kte, Rp, Cte, Hh, Mm, Mm, Ww, Ww^Es, Mm, Md^Xm, Md^Xm, Md^Xm
Mm, Mm, Hh, Mm, Mm, Mm, Mm, Mm, Mm, Hh, Cte, Cte, Cte, Cte, Rp, Hh, Mm, Mm, Ww, Mm, Mm, Md^Xm, Mm, Md^Xm
Mm, Hh, Mm, Mm, Mm, Mm, Mm, Mm, Mm, Mm, Mm, Rp, Rp, Cte, Mm, Mm, Mm, Mm, Ww, Mm, Mm, Mm, Md^Xm, Md^Xm
Mm, Hh, Hh, Mm, Mm, Mm, Mm, Mm, Mm, Hh, Hh, Mm, Mm, Rr, Mm, Mm, Mm, Mm, Ww^Es, Mm, Md^Xm, Md^Xm, Gg, Mm
Mm, Mm, Mm, Mm, Mm, Mm, Hh, Mm, Mm, Mm, Mm, Mm, Rr, Rr, Mm, Mm, Mm, Mm, Wwr, Ww^Es, Gs^Fms, Gs^Fms, Gg, Hh
Mm, Mm, Mm, Mm, Mm, Hh, Mm, Hh, Mm, Mm, Mm, Mm, Rr, Mm, Mm, Mm, Mm, Mm, Wwr, Ww^Es, Mm, Hh, Hh, Mm
Mm, Mm, Mm, Mm, Mm, Mm, Mm, Mm, Mm, Mm, Mm, Mm, Hh, Mm, Md, Md, Md, Md, Md, Ww^Es, Mm, Mm, Mm, Mm
Mm, Mm, Mm, Mm, Mm, Mm, Mm, Mm, Mm, Mm, Mm, Mm, Rr, Mm, Hh, Gd, Hhd, Md, Gd, Ww^Es, Ww^Es, Gs^Fms, Hh, Hh
Mm, Mm, Mm, Mm, Mm, Hh^Vhh, Mm, Mm, Mm, Mm, Mm, Mm, Mm, Rp, Gs, Gs, Gs, Hhd, Gs, Gs, Gs, Ww^Ewl, Ww, Gg
Mm, Mm, Mm, Mm, Mm, Hh, Mm, Mm, Mm, Mm, Hh^Vhh, Mm, Gg, Rp, Gg, Gs^Fms, Hh, Gs, Hh, Gs, Gs, Gs, Ww, Gg
Mm, Mm, Gs^Fms, Mm, Hh, Hh, Gg, Hh, Hh, Hh, Gg, Gg, Rp, Gg, Gg, Gs^Fms, Gs^Fms, Hh, Hh, Gg, Gs, Ww, Gg, Gg
Mm, Gs^Fms, Hh, Hh, Hh, Gs^Fms, Rp, Gg, Gg, Hh, Gg, Gg, Rp, Gg, Gs, Gg, Gs^Fms, Gg, Gll, Gg, Ww, Ww, Gs, Gg
Hh, Hh, Gs^Fms, Gs^Fms, Gs^Fms, Gs^Fms, Gg, Rp, Gg, Gg, Gg, Gg, Gll, Gs, Gs^Fms, Gs^Fms, Rb, Gs^Fms, Re, Gll, Ww^Es, Gs, Gg, Gs
Gg, Gg, Gg, Gg, Gg, Gg, Rp, Rp, Rp, Rr, Rr, Rp, Re, Re, Gs^Fms, Rb, Sm, Rb, Ss, Ss, Ss, Gll, Gll, Gg
Gg, Gg, Gg^Eff, Gg, Gg, Gg, Gg, Gg, Gg, Gg, Gg, Rr, Gs^Fms, Gs^Fms, Ss, Sm, Ss, Ss, Wo, Wo, Sm, Re, Re, Gll
Gg^Eff, Gg^Eff, Gg^Gvs, Gg^Eff, Gg^Eff, Gg, Gg, Gs, Gs^Fms, Gg, Gll, Gll, Gs^Fms, Gs^Fms, Ss, Gg, Gg, Gg, Gd, Rb, Rb, Rb, Re, Gll
Gg^Gvs, Gg^Gvs, Gg^Gvs, Gg^Gvs, Gs^Vh, Gg^Eff, Gg, Gs, Hh, Gs^Fms, Gs, Gs, Gll, Gs^Fms, Wo, Gg, Gg, Gs, Gs, Gd, Rb, Re, Rb, Re
Gg^Eff, Gg^Gvs, Gg^Gvs, Gg^Gvs, Gg^Gvs, Gs, Gg^Gvs, Gg, Hh, Gs^Fms, Gs, Gs, Gs, Gs^Fms, Gll, Wo, Ss, Gs, Gd, Rb, Sm, Rb, Gll, Gll
Gg, Gg^Eff, Gg, Gg^Gvs, Gg^Gvs, Gs, Gg^Gvs, Gg, Gg, Gs^Fms, Gg, Gs, Rp, Gs^Fms, Gs^Fms, Gll, Gs^Fms, Ss, Ss, Rb, Rb, Gll^Fmf, Sm, Gll
Hh, Gg, Gg, Gg, Gs^Fms, Gs, Gg, Gg, Gg, Gg, Gg, Gg, Rp, Gg, Gs, Gs^Fms, Gs^Fms, Sm, Ww^Es, Ww^Es, Sm, Sm, Rb, Rb
Hh, Gs^Fms, Hh, Gs^Fms, Gg, Gg, Ww, Ww, Ww, Gg, Rb, Gg, Rr, Rb, Ch, Re, Ww, Ww, Re, Rb, Rb, Rb, Gs, Re
Ww, Hh, Ww^Ewl, Gg, Ww^Ewf, Ww, Ww, Ww, Ww^Es, Ww^Es, Wwr, Ch, Ww^Bsb|, Ww^Es, Wwr, Ww^Es, Gg, Gll, Gll, Re, Gll, Gs, Gs, Gs
Ww, Ww, Gg, Ww^Ewf, Gg, Gg, Gg, Ch, Gg, Gg, Gg, Ww^Es, Rr, Ww^Es, Gg, Gs, Gs, Gs, Gs, Gs, Gs, Gs, Gg, Gs
Hh, Gg, Hh, Gg, Gg, Gg, Gg, Gg, Gg, Gg, Gg, Rr, Gg, Gg, Gg, Gg, Gg, Gg, Hh, Gg, Gg, Gg, Gg, Gg
Hh, Gs^Fms, Gg, Gs^Fms, Gg, Gg, Ch, Gg, Gg, Gg, Gg, Rrc, Gg, Gg, Gg, Gg, Gg, Gs^Fms, Gs^Fms, Hh, Gg, Gg^Efm, Gg^Efm, Gg^Efm
Gg, Gg, Ch, Gg, Ch, Ch, Ch, Ch, Ch, Ch, Ch, Rrc, Ch, Gg, Gg, Gg, Gg, Gg, Gg, Gg, Gg, Gg^Efm, Gg^Efm, Gg^Efm
Ch, Ch, Rrc, Ch, Rrc, Ch, Kh, Ch, Rrc, Rrc, Rrc, Ch, Rrc, Ch, Ch, Ch, Ch, Kh, Ch, Gg, Gg, Gg, Gg, Gg^Efm
Rrc, Rrc, Rrc, Rrc, Rrc, Ch, Ch, Rrc, Rrc, Rrc, Rrc, Rrc, Rrc, Rrc, Rrc, Rrc, Rrc, Ch, Rrc, Ch, Ch, Gg, Gg, Gg^Efm
Rrc, Rrc, Rrc, Rrc, Rrc, Rrc, Rrc, Rrc, Rrc, Rrc, Rrc, Rrc, Rrc, Rrc, Rrc, Rrc, Rrc, Rrc, Rrc, Rrc, Rrc, Kh, Ch, Ch
