Xu, Xu, Xu, Xu, Xu, Xu, Xu, Xu, Xu, Xu, Xu, Xu, Xu, Xu, Xu, Xu, Xu, Xu, Xu, Xu, Xu, Xu, Xu, Xu, Xu, Xu, Xu, Xu, Xu, Xu, Xu, Xu
Xu, Xu, Xu, Xu, Xu, Xu, Xu, Xu, Xu, Xu, Uu^Em, Uu^Em, Uu^Em, Xu, Urb, Urb, Uu^Vu, Urb, Urb, Uu^Edb, Uu^Edb, Xu, Xu, Xu, Xu, Xu, Xu, Xu, Xu, Xu, Xu, Xu
Xu, Xu, Xu, Xu, Xu, Xu, Xu, Xu, Uu^Em, Uu^Emf, Uu^Em, Uu^Em, Urb, Urb, Uu^Ecf, Xu, Xu, Uu, Uu^Edb, Uu^Edb, Uu^Edb, Uu^Edb, Xu, Xu, Xu, Xu, Xu, Xu, Xu, Xu, Xu, Xu
Xu, Xu, Xu, Xu, Xu, Xu, Xu, Cud, Uu, Uu^Em, Urb, Uu, Xuc, Xu, Uu^Edb, Uu^Edb, Uu^Edb, Xu, Xu, Uu^Edb, Uu^Edb, Uu^Edb, Xu, Xu, Xu, Xu, Xu, Xu, Xu, Xu, Xu, Xu
Xu, Xu, Xu, Xu, Xu, Xu, Cud, Cud^Edt, Uu^Edt, Uu, Urb, Xuc, Uu^Ecf, Xu, Xu, Uu^Edb, Uu^Edt, Uu^Edt, Xu, Uu, Xu, Xu, Cud, Xu, Uu^Uf, Xu, Xu, Xu, Xu, Xu, Xu, Xu
Xu, Xu, Xu, Xu, Xu, Xu, Uu, Uu^Esd, Urb^Edt, Urb^Edt, Xuc, Xu, Urb, Uu^Edb, Uu^Edt, Xu, Xu, Xu, Uu^Edt, Urb, Xu, Cud^Edb, Uue, Uue, Xu, Xu, Xu, Xu, Xu, Xu, Xu, Xu
Xu, Xu, Xuc, Xu, Cud, Xu, Uu, Urb, Uu, Xuc, Uu^Edb, Urb^Edb, Urb^Edb, Urb, Uu^Edt, Uu^Es, Xu, Uu^Edt, Xu, Uu^Ecf, Uu^Edb, Uue, Uue, Xu, Xu, Xu, Xuc, Xuc, Xu, Xu, Xu, Xu
Xu, Xu, Xuc, Xuc, Xuc, Uu, Uu, Urb, Uue^Edt, Xu, Uu^Edt, Urb^Edb, Urb^Edb, Xu, Uu^Edt, Uu^Edt, Uu^Edb, Xu, Uu, Uu, Urb^Edb, Uue, Xu, Xu, Xu, Xuc, Uu^Emf, Wwg, Wwg, Xu, Xu, Xu
Xu, Xu, Xuc, Xuc, Xuc, Uu^Edb, Urb^Edt, Uu, Uu^Ecf, Xu, Xu, Urb^Edb, Xu, Xu, Xu, Uu^Edb, Uu, Xu, Uue, Uu, Urb^Edb, Uu, Xu, Xu, Xuc, Xuc, Uu, Uu^Uf, Uu^Em, Wwg, Wwrg, Xu
Xos, Xuc, Xuc, Xuc, Uu^Edb, Urb^Edt, Urb, Xu, Uu, Uu, Xu, Xu, Uu^Edb, Uu^Es, Uu^Edt, Xu, Uu^Vu, Uu, Uu^Edt, Uu^Edt, Urb, Uu, Xuc, Xuc, Xuc, Xuc, Uu^Es, Uu^Edt, Uu^Emf, Wwg, Xu, Xu
Xos, Uu^Edb, Xuc, Uu^Edb, Uu^Edb, Urb, Urb, Xu, Uu, Uu^Vud, Xu, Uu^Edb, Uu^Edb, Uu^Edt, Uu^Ecf, Xu, Xu, Uu, Uu^Edt, Uu^Edt, Urb^Edt, Uu^Edt, Xuc, Xuc, Xu, Xu, Uh, Uu^Es, Xu, Wwg, Wwg, Xu
Xos, Xuc, Xuc, Uu, Cud, Urb, Urb, Xu, Xu, Xu, Uu^Em, Xu, Xu, Xu, Uu, Uu, Urb, Urb, Uu, Uu^Edt, Uu^Edb, Urb^Edt, Uu, Xu, Uu^Edt, Uu, Uu^Es, Xu, Uue^Em, Uu^Em, Wwg, Xu
Xos, Xuc, Xuc, Uu, Cud, Urb, Cud^Edt, Urb, Urb, Uu^Em, Uu, Uu^Em, Xu, Uu^Edt, Uu^Edt, Uu^Edt, Uu^Edt, Xu, Xu, Uu, Urb^Edt, Urb^Edt, Uu^Edb, Uu, Uu, Uu^Edt, Uu^Es, Xu, Xu, Uu^Em, Uh^Emf, Xu
Xu, Xuc, Xuc, Uu, Uu, Cud^Edt, Urb, Cud^Edt, Cud^Edt, Urb, Uu, Uu, Uu, Xu, Xu, Uu, Uu, Xu, Xu, Uu, Urb, Uu^Edb, Uu^Edb, Uu^Edb, Xu, Uu, Xu, Xu, Xu, Uu, Xuc, Xuc
Xu, Uu, Xuc, Uu^Edb, Uu^Edb, Uu, Urb, Urb, Cud, Urb, Urb, Uu^Edt, Uu^Em, Uu^Em, Wwg, Xuc, Uu, Uu^Es, Uu, Xu, Uu, Uu^Edb, Xu, Xu, Xu, Xu, Qxu, Uu^Vu, Xu, Uu^Vu, Xu, Xuc
Xu, Uu^Edb, Uu^Edb, Xuc, Xuc, Uu^Edb, Uu, Cud, Uu, Urb, Urb, Uu^Edt, Uu^Edt, Uu^Emf, Wwg, Xuc, Xu, Uu^Es, Xu, Xu, Xu, Uu, Xu, Xu, Uu, Uu, Qxu, Uu, Xu, Xu, Xu, Xuc
Xu, Urb^Edb, Uu^Edb, Uu^Edb, Xuc, Uu^Edb, Uu, Uu^Edt, Uu^Edt, Uu, Urb^Edb, Uu, Uu^Em, Uu^Uf, Xu, Xu, Xu, Xu, Xu, Xu, Urb, Xu, Urb^Edt, Uu^Edt, Qxu^Bs\, Qxu, Ur, Qxu, Qxu, Qxu, Qxu, Xu
Xu, Uu^Edb, Uu^Edb, Uu^Edb, Uu, Xuc, Uu, Uu, Uu, Uu^Edt, Uu^Edt, Urb^Edb, Uu, Uu^Em, Xu, Xu, Xu, Uu^Edt, Uu^Edt, Uu, Xu, Urb^Edb, Xu, Qxu, Qxu, Ur, Qxu, Qxu^Bp\, Ur, Qxu, Qxu, Xu
Xu, Xu, Uu^Edb, Uu^Edb, Uu, Urb, Uu, Uu, Xu, Xu, Urb, Uu, Xu, Xu, Uh^Es, Xu, Xu, Uu^Edt, Xu, Xu, Urb^Es, Xu, Qxu, Qxu, Qxu, Qxu, Qxu, Qxu, Qxu, Ur^Es, Qxu, Xu
Xu, Xu, Uu, Uu^Edb, Uu, Urb, Uu, Xu, Xu, Urb^Edb, Uu, Uu, Uh^Edt, Uh^Es, Xu, Xu, Xu, Xu, Xu, Urb^Es, Qxu, Qxu^Bs\, Ur, Qxu, Qxu, Qxua, Qxua, Qxu, Qxu, Qxu^Bp|, Xuce, Xu
Xu, Uu^Em, Xu, Uu, Urb, Urb, Uu, Xu, Xu, Urb^Edb, Uu, Uu, Uu, Xu, Uu^Es, Uu, Uu, Xu, Uu, Urb, Qxu, Qxu, Qxua, Ur^Es, Qxu^Bs\, Qxu, Qxu, Qxu, Qxu, Uue, Xuce, Xu
Xu, Xu, Uu^Em, Uu, Uu, Uu, Xu, Uu^Vud, Xu, Urb^Edb, Uu^Dr, Uu, Uu^Es, Uu^Es, Uu^Es, Uu^Es, Uu, Xu, Uu, Qxu, Qxu, Qxu, Qxua, Qxu, Qxu, Ur, Qxu^Bs\, Qxu, Ur, Uue, Xuc, Xu
Xu, Uu^Uf, Xu, Xu, Xu, Xu, Xu, Xu, Xu, Uh^Edb, Uu, Urb, Urb, Uu^Es, Uu, Uu, Urb^Es, Xu, Qxu, Qxu^Bs\, Ur^Es, Qxu, Qxu, Qxu, Qxu, Qxu, Xuc, Ur, Xu, Xuce, Ms^Xm, Ms^Xm
Xu, Xu, Xu, Xu, Xu, Xu, Uue^Emf, Xu, Xu, Uh^Edt, Xu, Xu, Uu, Urb, Urb^Es, Urb^Es, Qxu^Bs\, Qxu, Qxu, Qxu, Qxu^Bp|, Qxu, Qxu, Qxu, Xue, Xue, Ms^Xm, Xuc, Ms^Xm, Ms^Xm, Ms^Xm, Ms^Xm
Xu, Xu, Xu, Uue, Xu, Uue, Uu, Xu, Uu, Xu, Uu, Uu, Uu, Urb^Es, Uu, Uu, Qxua, Urb, Qxu^Bs\, Qxu, Ur^Es, Qxu, Qxu, Qxu, Xue, Xu, Ms^Xm, Ms^Xm, Ms^Xm, Ms^Xm, Ms, Ms
Mm^Xm, Xu, Uu^Vud, Uu, Uu, Xu, Uu, Uu, Uu^Edt, Uu, Uu, Uu, Uu, Urb, Uue^Em, Uue^Em, Xu, Qxua, Qxua, Ur, Qxu, Qxu, Xue, Xue, Xu, Xu, Xu, Xu, Ms^Xm, Ms^Xm, Ms, Ms
Mm^Xm, Xu, Xu, Uu, Urb^Edt, Uu^Edt, Urb, Urb^Edb, Uu^Edt, Uu^Edt, Uu, Uu, Urb^Es, Uu, Xu, Xuc, Uue, Xuce, Xu, Qxu^Bs|, Qxu, Qxe, Uue, Uue, Md^Xm, Mm^Xm, Mm^Xm, Mm^Xm, Ha, Ha, Ms, Ms
Mm^Xm, Mm^Xm, Mm^Xm, Xu, Xu, Urb^Edt, Xu, Uu, Urb^Es, Xu, Xu, Urb^Es, Xu, Xu, Xu, Uue, Mm, Uue, Uue, Uue, Qxe, Qxe, Uue, Uue, Mm, Mm, Mm, Mm, Mm, Mm, Ms^Xm, Ms^Xm
Hh, Mm^Xm, Hhd^Vhhr, Mm^Xm, Mm^Xm, Xu, Xu, Xu, Xu, Xu, Xu, Xu, Mm^Xm, Xu, Mm^Xm, Mm^Xm, Mm, Mm, Uue, Uue, Qxe, Uue, Md, Md, Hh, Mm, Mm, Mm, Mm, Mm, Ms^Xm, Ms
Gg, Hh, Gg, Hh, Hh, Mm^Xm, Mm^Xm, Mm^Xm, Mm^Xm, Xu, Mm^Xm, Mm^Xm, Hh, Mm, Hh, Hh, Gg, Hh, Re, Qxua, Uue, Uue, Mm, Hh, Gs^Fds, Mm, Mm, Mm, Mm^Xm, Mm^Xm, Mm^Xm, Ms^Xm
Rp, Gg, Gs^Fds, Gg, Gs^Fds, Hh, Mm, Mm, Mm, Mm^Xm, Mm, Mm, Hh, Hh, Hh, Hh, Gg, Gs, Re, Re, Hh, Hh, Hh, Gs^Fds, Gg, Mm, Mm, Mm^Xm, Mm, Mm^Xm, Mm, Mm^Xm
Gs^Fds, Rp, Gg, Gs^Fds, Gg, Gs^Fds, Gs^Fds, Mm, Mm, Mm, Hh, Hh, Hh, Hh, Gs^Fds, Gs^Fds, Rd, Rd, Gg, Gg, Gg, Hh, Gs^Fds, Gs^Fds, Gg, Mm, Mm, Mm, Mm, Mm, Mm, Mm^Xm
