Xu, Xu, Xu, Xu, Xu, Xu, Xu, Xu, Xu, Xu, Xu, Xu, Xu, Xu, Xu, Xu, Xu, Xu, Xu, Xu, Xu, Xu, Xu, Xu, Xu, Xu, Xu, Xu, Xu, Xu, Xu, Xu, Xu, Xu, Xu, Xu, Xu, Xu
Xu, Xu, Xu, Xu, Xu, Xu, Xu, Xu, Xu, Xu, Xu, Xu, Xu, Xu, Xu, Xu, Xu, Xu, Xu, Xu, Xu, Xu, Xu, Xu, Xu, Xu, Xu, Xu, Xu, Xu, Xu, Xu, Xu, Xu, Xu, Xu, Xu, Xu
Xu, Xu, Xu, Xu, Xu, Xu, Xu, Xu, Xu, Xu, Xu, Xu, Xu, Xu, Xu, Xu, Xu, Xu, Xu, Xu, Xu, Xu, Xu, Xu, Xu, Xu, Xu, Xu, Xu, Xu, Xu, Xu, Xu, Xu, Xu, Xu, Xu, Xu
Xu, Xu, Xu, Xu, Xu, Xu, Xu, Xu, Xu, Xu, Xu, Xu, Xu, Xu, Xu, Xu, Xu, Xu, Xu, Xu, Xu, Xu, Xu, Xu, Xu, Xu, Xu, Xu, Xu, Xu, Xu, Xu, Xu, Xu, Xu, Xu, Xu, Xu
Xu, Xu, Xu, Xu, Xu, Xu, Xu, Xu, Xu, Xu, Xu, Xu, Xu, Xu, Xu, Xu, Xu, Xu, Xu, Xu, Xu, Xu, Xu, Xu, Xu, Xu, Xu, Xu, Xu, Xu, Xu, Xu, Xu, Xu, Xu, Xu, Xu, Xu
Xu, Xu, Xu, Xu, Xu, Xu, Xu, Xu, Xu, Xu, Xu, Xu, Xu, Xu, Xu, Xu, Xu, Xu, Xu, Xu, Xu, Xu, Xu, Xu, Xu, Xu, Xu, Xu, Xu, Xu, Xu, Xu, Xu, Xu, Xu, Xu, Xu, Xu
Xu, Xu, Xu, Xu, Xu, Xu, Xu, Xu, Xu, Xu, Xu, Xu, Uu^Em, Uu^Em, Uu^Em, Uu, Uu, Uu, Uu, Rr, Rr, Uu^Edb, Xu, Xu, Xu, Xu, Xu, Xu, Xu, Xu, Xu, Xu, Xu, Xu, Xu, Xu, Xu, Xu
Xu, Xu, Xu, Xu, Xu, Xu, Xu, Xu, Xu, Xu, Uu^Em, Uu^Emf, Uu^Em, Uu^Em, Ur, Ur, Uu^Ecf, Uu, Uu, Rr, Xu, Xu, Rr, Rr, Rr, Xu, Xu, Xu, Xu, Xu, Xu, Xu, Xu, Xu, Xu, Xu, Xu, Xu
Xu, Xu, Xu, Xu, Xu, Xu, Xu, Xu, Xu, Cud, Uu, Uu^Em, Ur, Uu, Xuc, Xu, Uu^Edb, Uu^Edb, Xu, Rr^Pr/, Rr, Rr, Rr, Rr^Eb, Rr, Xu, Rr, Xu, Xu, Xu, Xu, Xu, Xu, Xu, Xu, Xu, Xu, Xu
Xu, Xu, Xu, Xu, Xu, Xu, Xu, Xu, Cud, Cud^Edt, Ur, Uu, Ur, Xuc, Uu^Ecf, Xu, Xu, Uu^Edb, Xu, Rr, Rr, Rr, Rr, Rr, Xu, Xu, Rr, Rr, Xu, Xu, Xu, Xu, Xu, Xu, Xu, Xu, Xu, Xu
Xu, Xu, Xu, Xu, Xu, Xu, Xu, Xu, Uu, Ur, Ur, Ur, Xuc, Xu, Ur, Uu^Edb, Ur, Xu, Xu, Xu, Rr, Rr, Xu, Xu, Rr^Pr\, Rr, Rr, Xu, Xue, Xu, Xue, Xu, Xue, Xu, Xu, Xu, Xu, Xu
Xu, Xu, Xu, Xu, Xuc, Xu, Cud, Xu, Uu, Ur, Uu, Xuc, Uu^Edb, Ur, Ur, Ur, Uu^Edt, Uu^Es, Xu, Rr, Xu, Rr^Pr/, Rr, Rr, Qxu, Xu, Xu, Rr, Xue, Xue, Uue, Xue, Uue, Uue, Xue, Xue, Xu, Mm^Xm
Xu, Xu, Xu, Xu, Xuc, Xuc, Xuc, Uu, Uu, Ur, Uue^Edt, Xu, Uu^Edt, Uu, Rr, Xu, Rr, Uu^Edt, Uu^Edb, Xu, Uu, Ur, Ur, Qxu, Xu, Xu, Xu, Xue, Uue^Emf, Wwg, Wwg, Uue, Qxu, Wot, Wot, Xue, Xu, Xu
Xu, Xu, Xu, Xu, Xuc, Xuc, Xuc, Uu^Edb, Ur, Uu, Uu^Ecf, Xu, Xu, Rr, Xu, Xu, Xu, Rr, Rr^Pr/, Xu, Uue, Uu, Ur, Uu, Xu, Xu, Xuc, Xue, Uu, Uu^Uf, Uue^Ii, Wot, Qxu, Qxu, Wot, Xue, Xu, Xu
Xu, Xu, Uu, Xuc, Xuc, Xuc, Uu^Edb, Ur, Ur, Xu, Uu, Uu, Xu, Xu, Ur, Ur, Ur, Xu, Uu^Vu, Uu, Uu^Edt, Uu^Edt, Ur, Uu, Xuc, Xuc, Xuc, Xu, Uu^Es, Uu^Edt, Uue^Emf, Wot, Wot, Wot, Uue, Xue, Xu, Xu
Xu, Xu, Uu, Uu^Edb, Xuc, Uu^Edb, Uu^Edb, Ur, Ur, Xu, Uu, Uu^Vud, Xu, Ur, Ur, Ur, Rr^Pr/, Xu, Xu, Uu, Uu^Edt, Uu^Edt, Ur, Uu^Edt, Xuc, Xuc, Xu, Xu, Uh, Uu^Es, Xu, Wwg, Wwg, Xue, Xu, Xu, Xu, Xu
Xu, Xu, Uu^Esd, Xuc, Xuc, Uu, Cud, Ur, Ur, Xu, Xu, Xu, Uu^Em, Xu, Xu, Xu, Uu, Rr, Rr, Rr^Pr\, Xu, Uu^Edt, Uu^Edb, Ur, Uu, Xu, Uu^Edt, Uu, Uu^Es, Xu, Uue^Emf, Uue, Wwg, Xue, Xu, Xu, Xu, Xu
Xu, Xu, Uu, Xuc, Xuc, Uu, Cud, Ur, Cud^Edt, Ur, Ur, Uu^Em, Uu, Uu^Em, Xu, Uu^Edt, Uu^Edt, Uu^Edt, Ur, Xu, Xu, Uu, Ur, Ur, Uu^Edb, Uu, Uu, Uu^Edt, Uu^Es, Xu, Xu, Uue^Edb, Uh^Emf, Xue, Xu, Xu, Xu, Mm^Xm
Xu, Xu, Uu^Edb, Xuc, Xuc, Uu, Uu, Cud^Edt, Urb, Cud^Edt, Cud^Edt, Ur, Uu, Uu, Uu, Xu, Xu, Uu, Rr^Pr/, Xu, Xu, Uu, Ur, Uu^Edb, Uu^Edb, Uu^Edb, Xu, Uu, Xu, Xu, Xu, Uue^Edb, Xu, Xue, Xu, Xu, Xu, Xu
Xu, Xu, Uu^Edb, Uu, Xuc, Uu^Edb, Uu^Edb, Uu, Urb, Urb, Cud, Ur, Ur, Uu^Edt, Uu^Em, Uu^Em, Wwg, Xuc, Uu, Rr, Ur, Xu, Uu, Uu^Edb, Xu, Xu, Xu, Xu, Qxu, Uu^Vu, Xu, Uu^Vud, Xu, Xu, Xu, Xu, Xu, Xu
Xu, Xu, Uu^Edb, Uu^Edb, Uu^Edb, Xuc, Xuc, Uu^Edb, Uu, Cud, Uu, Ur, Ur, Uu^Edt, Uu^Edt, Uu^Emf, Wwg, Xuc, Xu, Uu, Xu, Xu, Xu, Uu, Xu, Xu, Uu, Uu, Qxu, Uu, Xu, Xu, Xu, Xuc, Xu, Xu, Xu, Xu
Xu, Xu, Urb^Edb, Urb^Edb, Uu^Edb, Uu^Edb, Xuc, Uu^Edb, Uu, Uu^Edt, Uu^Edt, Uu, Ur, Uu, Uu^Em, Uu^Uf, Xu, Xu, Xu, Xu, Xu, Xu, Urb, Xu, Urb^Edt, Uu^Edt, Qxu^Bs\, Qxu, Ur, Qxu, Qxu, Qxu, Qxu, Xu, Xu, Xu, Xu, Xu
Xu, Xu, Uu^Edb, Uu^Edb, Uu^Edb, Uu^Edb, Uu, Xuc, Uu, Uu, Uu, Uu^Edt, Uu^Edt, Ur, Uu, Uu^Em, Xu, Xu, Xu, Uu^Edt, Uu^Edt, Uu, Xu, Urb^Edb, Xu, Qxu, Qxu, Ur, Qxu, Qxu^Bp\, Ur, Qxu, Qxu, Qxu, Xu, Xu, Xu, Xu
Xu, Xu, Uu^Edb, Uu^Edt, Uu^Edb, Uu^Edb, Uu, Urb, Uu, Uu, Xu, Xu, Urb, Uu, Xu, Xu, Uh^Es, Xu, Xu, Uu^Edt, Xu, Xu, Urb^Es, Xu, Qxu, Qxu, Qxu, Qxu, Qxu, Qxu, Qxu, Ur^Es, Qxu, Xu, Xu, Xu, Xu, Xu
Xu, Xu, Uu^Em, Uu^Edb, Uu, Uu^Edb, Uu, Urb, Uu, Xu, Xu, Urb^Edb, Uu, Uu, Uh^Edt, Uh^Es, Xu, Xu, Xu, Xu, Xu, Urb^Es, Qxu, Qxu^Bs\, Ur, Qxu, Qxu, Qxua, Qxua, Qxu, Qxu, Qxu^Bp|, Xuce, Xu, Xu, Xu, Xu, Xu
Xu, Xu, Xu, Uu^Em, Xu, Uu, Urb, Urb, Uu, Xu, Xu, Urb^Edb, Uu, Uu, Uu, Xu, Uu^Es, Uu, Uu, Xu, Uu, Urb, Qxu, Qxu, Qxua, Ur^Es, Qxu^Bs\, Qxu, Qxu, Qxu, Qxu, Uue, Xuce, Xu, Xu, Xu, Xu, Xu
Xu, Xu, Xu, Xu, Uu^Em, Uu, Uu, Uu, Xu, Uu^Vud, Xu, Urb^Edb, Uu^Dr, Uu, Uu^Es, Xu, Uu^Es, Uu^Es, Uu, Xu, Uu, Qxu, Qxu, Qxu, Qxua, Qxu, Qxu, Ur, Qxu^Bs\, Qxu, Ur, Uue, Xu, Xu, Xu, Xu, Mm, Mm
Xu, Xu, Xu, Uu^Uf, Xu, Xu, Xu, Xu, Xu, Xu, Xu, Uh^Edb, Uu, Urb, Urb, Uu^Es, Uu, Uu, Urb^Es, Xu, Qxu, Qxu^Bs\, Ur^Es, Qxu, Qxu, Qxu, Qxu, Qxu, Xuc, Ur, Xu, Xu, Xu, Xu, Xu, Xu, Mm, Mm
Xu, Xu, Xu, Xu, Xu, Xu, Xu, Xu, Uue^Emf, Xu, Xu, Uh^Edt, Xu, Xu, Uu, Urb, Urb^Es, Urb^Es, Qxu^Bs\, Qxu, Qxu, Qxu, Qxu^Bp|, Qxu, Qxu, Qxu, Xue, Xue, Xu, Xu, Xu, Xu, Xu, Xu, Gg, Gs^Fds, Gs^Fds, Mm
Xu, Xu, Xu, Xu, Xu, Uue, Xu, Uue, Uu, Xu, Uu, Xu, Uu, Uu, Uu, Urb^Es, Uu, Uu, Qxua, Urb, Qxu^Bs\, Qxu, Ur^Es, Qxu, Qxu, Qxu, Xue, Xu, Xu, Xu, Xu, Xu, Hh, Hh, Gg, Gg, Mm, Mm
Xu, Xu, Xu, Xu, Uu^Vud, Uu, Uu, Xu, Uu, Uu, Uu^Edt, Uu, Uu, Uu, Uu, Urb, Uue^Em, Uue^Em, Xu, Qxua, Qxua, Ur, Qxu, Qxu, Xue, Xue, Xu, Xu, Xu, Xu, Hh, Hh, Gs^Fds, Gg, Mm, Mm, Mm, Mm
Xu, Xu, Xu, Xu, Xu, Uu, Urb^Edt, Uu^Edt, Urb, Urb^Edb, Uu^Edt, Uu^Edt, Uu, Uu, Urb^Es, Uu, Xu, Xuc, Uue, Xuce, Xu, Qxu^Bs|, Qxu, Qxe, Uue, Uue, Mm^Xm, Mm^Xm, Hh, Hh, Gs^Fds, Gs^Fds, Mm, Mm, Mm, Mm, Mm, Mm
Xu, Xu, Xu, Xu, Xu, Xu, Xu, Urb^Edt, Xu, Uu, Urb^Es, Uu, Uu, Urb^Es, Xu, Xu, Xu, Uue, Mm, Uue, Uue, Uue, Qxe, Qxe, Uue, Uue, Mm, Mm, Hh, Gll^Fmf, Mm, Mm, Mm, Mm, Mm, Mm, Mm^Xm, Mm^Xm
Xu, Xu, Xu, Xu, Xu, Xu, Xu, Xu, Xu, Xu, Xu, Urb^Es, Xu, Xu, Xu, Xu, Mm^Xm, Mm^Xm, Mm, Mm, Uue, Uue, Qxe, Uue, Mm, Mm, Hh, Hh, Mm, Mm, Mm, Mm, Mm, Mm, Mm^Xm, Mm^Xm, Mm, Mm
Mm, Mm, Mm, Xu, Xu, Xu, Xu, Xu, Xu, Xu, Xu, Xu, Xu, Xu, Xu, Xu, Hh, Hh, Gg, Hh, Re, Qxua, Uue, Uue, Mm, Hh, Mm, Mm, Mm, Mm, Mm, Mm, Mm^Xm, Mm^Xm, Mm^Xm, Mm^Xm, Mm, Mm
Mm, Mm, Mm, Mm, Mm, Mm, Mm, Mm, Mm, Xu, Xu, Xu, Xu, Mm, Hh, Hh, Hh, Hh, Gg, Gs, Re, Re, Hh, Hh, Mm, Mm, Mm, Mm, Mm, Mm, Mm^Xm, Mm, Mm^Xm, Mm^Xm, Mm^Xm, Mm, Mm^Xm, Mm^Xm
Mm, Mm, Mm, Mm, Mm, Mm, Mm, Mm, Mm, Mm, Mm, Xu, Hh, Hh, Hh, Hh, Gs^Fds, Gs^Fds, Gg, Gg, Gg, Gg, Mm, Mm, Mm, Mm, Mm, Mm, Mm, Mm^Xm, Mm^Xm, Mm^Xm, Mm^Xm, Mm^Xm, Mm, Mm^Xm, Mm^Xm, Mm^Xm
