Rp, Mm, Mm, Mm, Mm, Mm, Mm, Mm, Mm, Xu, Xu, Xu, Xu, Xu, Xu, Xu, Xu, Xu, Xu, Xu, Xu, Urb^Es, Xu, Xu, Xu, Xu, Mm^Xm, Mm^Xm, Mm, Mm, Uue, Uue, Qxe, Uue, Mm, Mm, Hh, Hh, Mm, Mm, Mm, Mm
Mm, Mm, Mm, Mm, Mm, Mm, Mm, Mm, Mm, Mm, Mm, Mm, Mm, Xu, Xu, Xu, Xu, Xu, Xu, Xu, Xu, Xu, Xu, Xu, Xu, Xu, Hh, Hh, Gg, Hh, Re, Qxua, Uue, Uue, Mm, Hh, Mm, Mm, Mm, Mm, Mm, Mm
Mm, Mm, Mm, Mm, Mm, Mm, Mm, Mm, Gg, Mm, Mm, Mm, Mm, Mm, Mm, Mm, Mm, Mm, Mm, Xu, Xu, Xu, Xu, Mm, Hh, Hh, Hh, Hh, Gg, Gs, Re, Re, Hh, Hh, Mm, Mm, Mm, Mm, Mm, Mm, Mm^Xm, Mm
Gg, Gg, Gg, Mm, Gg, Gg, Gg, Mm, Gg, Mm, Mm, Mm, Mm, Mm, Mm, Mm, Mm, Mm, Mm, Mm, Mm, Xu, Hh, Hh, Hh, Hh, Gs^Fds, Gs^Fds, Gg, Gg, Rb, Gg, Mm, Mm, Mm, Mm, Mm, Mm, Mm, Mm^Xm, Mm^Xm, Mm^Xm
Rp, Gg, Rp, Gg, Gg, Gg, Gg, Gg, Gg, Mm, Mm, Mm, Mm, Mm, Mm, Mm, Mm, Mm, Mm, Mm, Mm, Mm, Gg, Gg, Gg, Gs^Fds, Gs^Fds, Gg, Gg, Gg, Rb, Gg, Mm, Mm, Mm, Mm, Gs^Fms, Mm, Gs^Fms, Mm, Mm, Mm
Gg, Gg, Gg, Re, Re, Re, Re, Gg, Gg, Gg, Gg, Mm, Mm, Mm, Mm, Mm, Mm, Mm, Mm, Mm, Mm, Mm, Gg, Gg, Gg, Gg, Gg, Gg, Gg, Gg, Rd, Gg, Gg, Mm, Mm, Mm, Gs^Fms, Gs^Fms, Mm, Gs^Fms, Gg, Mm
Gg, Gg, Gg, Gg, Gs^Fds, Gg, Rp, Re, Gs^Vh, Gg, Gg, Gg, Gg, Mm, Mm, Mm, Gg, Gg, Gg, Mm, Gg, Gg, Gg, Gg, Gg, Gg, Re, Re, Gg, Gg, Rd, Gg, Gg, Mm, Hh, Mm, Gg, Mm, Hh, Hh, Hh, Hh
Gg, Gg, Gg, Gs^Fds, Hh, Hh, Gg, Re, Re, Gg, Gg, Gg, Gg, Gg, Gg, Gg, Gg, Gg, Gg, Gg, Gg, Gg, Gg, Gg, Gg, Gg, Re, Gg, Gg, Gg, Re, Rd, Gs^Fds, Gg, Hh, Hh, Gg, Hh, Hh, Gg, Gg, Mm
Gg, Gg, Gs^Fds, Gg, Hh, Hh, Gg, Rp, Re, Gg, Gg, Gg, Gg, Gg, Gg, Gg, Gg, Gg, Gs^Vh, Gg, Gg, Gg, Gg, Gg, Gg, Re, Re, Gg, Gg, Gg, Gg, Re, Hh, Gs^Fds, Gg, Gg, Gg, Hh, Gg, Gg, Gg, Gg
Gg, Gs^Fds, Gs^Fds, Hh, Hh, Hh, Gg, Hh, Re, Gg, Gg, Gg, Gg, Gg, Gg, Gg, Gg, Gg, Gg, Gg, Gg, Gg, Gg, Gg, Gg, Gg, Rp, Gg, Gg, Gg, Gs^Fds, Gs^Fds, Gg, Gs^Fds, Re, Rb, Re, Gg, Rd, Gg, Re, Gg
Gg, Gs^Fds, Gg, Hh, Hh, Hh, Gg, Gg, Gg, Re, Gg, Gg, Gg, Rp, Gg, Gg, Hh, Gg, Hh, Gg, Hh, Gg, Gg, Gg, Gg, Gg, Gg, Gg, Gg, Gg, Gs^Fds, Hh, Hh, Gg, Gg, Gg, Gg, Re, Rb, Rd, Rb, Rd
Gg, Gg, Gg, Hh, Gg, Hh, Gg, Gg, Gg, Re, Gg, Gg, Gs^Fds, Gg, Gg, Gs^Fds, Gg, Hh, Hh, Hh, Gg, Gg, Gg, Gg, Gg, Gg, Gg, Re, Gg, Gg, Gg, Gs^Fds, Gg, Gg, Gg, Gg, Gs^Fds, Gg, Gg, Gg, Gg, Gs^Fds
Gg, Gg, Gg, Gs^Fds, Gs^Fds, Gg, Gg, Hh, Gg, Re, Gs^Fds, Gs^Fds, Hh, Hh, Gg, Gg, Gg, Gg, Gg, Gg, Gg, Gg, Gg, Gg, Gg, Gg, Gg, Re, Gg, Gg, Gg, Gg, Gg, Gg, Gg, Hh, Gg, Gg, Gg, Gg, Gg, Gs^Fds
Gg, Gg, Gg, Gs^Fds, Gs^Fds, Gg, Gg, Gg, Gs^Fds, Re, Re, Gg, Gg, Gg, Gg, Gg, Gg, Gg, Gg, Gg, Gs^Vh, Gg, Gg, Gg, Gg, Gg, Re, Gg, Gg, Gg, Gs^Fds, Gs^Fds, Hh, Gs^Fds, Gs^Fds, Gs^Fds, Gg, Gg, Gg, Gg, Gg, Gg
Gg, Gg, Gg, Gg, Gg, Gg, Gg, Gg, Hh, Hh, Re, Rp, Rp, Re, Re, Gg, Gg, Gg, Gg, Gg, Gg, Gg, Gg, Gg, Gg, Gg, Gg, Gg, Hh, Hh, Gs^Fds, Hh, Gg, Gs^Fds, Gg, Gg, Gg, Gg, Gg, Gg, Gg, Gg
Gg, Gg, Gg, Gg, Gg, Gg, Gg, Gg, Gg, Gg, Gg, Gg, Gg, Gg, Gg, Gg, Re, Gg, Re, Gg, Gg, Gg, Gg, Gg, Gg, Gg, Re, Gg, Gg, Hh, Gg, Gg, Gg, Gg, Gg, Gg, Gg, Gg, Gg, Gs^Vh, Gg, Gg
Gg, Gg, Gs^Vh, Gg, Gg, Gg, Gg, Gg, Gg, Gg, Gg, Gg, Gg, Gg, Gg, Gg, Gg, Rp, Gg, Re, Gg, Gg, Gg, Gg, Gg, Gg, Rp, Gg, Gg, Gg, Gg, Gg, Gg, Gg, Gs^Fds, Gs^Fds, Hh, Gg, Gg, Gg, Gg, Gg
Gg, Gg, Gg, Gg, Gg, Gg, Gg, Gs^Fds, Gs^Fds, Gg, Gg, Gg, Gs^Fds, Hh, Hh, Gg, Gg, Gg, Gg, Rp, Gg, Gg, Gg, Gg, Gg, Gg, Gg, Rp, Re, Gg, Gg, Gg, Gg, Gs^Fds, Gs^Fds, Hh, Gg, Gg, Gg, Gg, Gg, Gg
Gg, Gg, Gg, Gg, Gg, Gg, Gg, Gg, Gs^Fds, Gg, Gg, Gg, Hh, Hh, Gs^Fds, Gs^Fds, Gs^Fds, Gg, Gg, Re, Gg, Gg, Gg, Gg, Gg, Gg, Gg, Gg, Rp, Gg, Gg, Gg, Gg, Gs^Fds, Gs^Fds, Gg, Gg, Gg, Gg, Gg, Gg, Gg
Gg, Gg, Gg, Gg, Gg, Gg, Gg, Gg, Hh, Hh, Hh, Gg, Gg, Hh, Hh, Hh, Gg, Gg, Gg, Rp, Gg, Gg, Gg, Gg, Gg, Gg, Gs^Vh, Gg, Gg, Rp, Re, Gg, Gg, Hh, Hh, Gs^Fds, Gs^Fds, Gg, Gg, Gg, Gg, Gg
Gg, Gg, Gg, Gg, Gg, Gg, Gg, Gg, Gs^Fds, Gs^Fds, Hh, Gg, Gg, Gg, Gs^Fds, Gg, Gg, Gg, Rp, Re, Gg, Gg, Gg, Gg, Gg, Gg, Gg, Gg, Gg, Gg, Re, Gg, Gs^Fds, Gg, Hh, Hh, Gg, Gg, Gg, Gg, Gg, Gg
Gg, Gg, Gg, Gg, Gg, Gs^Fds, Gg, Gg, Hh, Gs^Fds, Gg, Gg, Gg, Gg, Gg, Gg, Gg, Rd, Gg, Gg, Gg, Gg, Gg, Gg, Gg, Gg, Hh, Gs^Fds, Gg, Gg, Gg, Gg, Gg, Hh, Hh, Gg, Gg, Gg, Gg, Gg, Gg, Gg
Gg, Gg, Gg, Gg, Gg, Gs^Fds, Gg, Hh, Gg, Gs^Fds, Gg, Gg, Rp, Gg, Gg, Re, Gg, Gg, Gg, Gg, Gg, Gg, Gs^Fds, Gs^Fds, Hh, Hh, Hh, Gg, Gg, Re, Gg, Gg, Gs^Fds, Hh, Gg, Gg, Gg, Gg, Gg, Gg, Gs^Vh, Gg
Gg, Gg, Gg, Gg, Gg, Gs^Fds, Hh, Gg, Gg, Gs^Fds, Gg, Re, Gg, Rd, Gg, Gg, Gg, Gg, Gg, Gg, Gs^Fds, Gs^Fds, Gs^Fds, Hh, Hh, Gg, Gg, Gg, Rd, Rp, Gg, Gg, Gs^Fds, Hh, Gg, Gg, Gg, Gg, Gg, Gg, Gg, Gg
Gg, Gg, Gg, Gg, Gs^Fds, Gs^Fds, Gs^Fds, Hh, Gg, Gg, Rd, Rd, Gg, Gg, Gg, Gs^Vh, Gg, Gg, Gg, Gg, Gs^Fds, Hh, Hh, Hh, Hh, Hh, Gg, Gg, Re, Gg, Gg, Gs^Fds, Gg, Hh, Gg, Gg, Gg, Gg, Gg, Gg, Gg, Gg
Gg, Gg, Gg, Gg, Gg, Gs^Fds, Gg, Hh, Hh, Rp, Gg, Gg, Gg, Gg, Gg, Gg, Gg, Gg, Gg, Gg, Gg, Gs^Fds, Gs^Fds, Hh, Hh, Hh, Gg, Gg, Rp, Gg, Gg, Gg, Gg, Gg, Gg, Gg, Gs^Fds, Gg, Gg, Gg, Gg, Gg
Gg, Gg, Gg, Gg, Gg, Gg, Rp, Rp, Hh, Hh, Gg, Gg, Gg, Gg, Gg, Gg, Gg, Gg, Gg, Hh, Gs^Fds, Gs^Fds, Gs^Fds, Gs^Fds, Gs^Fds, Gs^Fds, Gg, Re, Rd, Gg, Gs^Vh, Gg, Gg, Gg, Gg, Gg, Gs^Fds, Gs^Fds, Gg, Gg, Gg, Gg
Gg, Gg, Gg, Gg, Gg, Gg, Rp, Re, Gg, Gs^Fms, Gg, Gg, Gg, Gg, Gg, Gg, Gg, Gg, Gg, Hh, Gg, Gs^Fds, Gs^Fds, Gs^Fds, Gs^Fds, Gg, Rp, Rp, Re, Gg, Gg, Gg, Gg, Gg, Gs^Fds, Gs^Fds, Gs^Fds, Hh, Hh, Gg, Gg, Gg
Gg, Gg, Gg, Gg, Hh, Re, Gs^Fds, Gg, Gg, Gg, Hh, Gg, Hh, Gg, Hh, Gg, Gg, Gg, Gg, Gg, Gg, Hh, Gg, Gs^Fds, Gg, Gg, Gg, Gg, Gg, Gg, Gg, Gg, Gg, Gg, Gs^Fds, Gs^Fds, Gs^Fds, Gg, Gg, Hh, Gg, Gg
Gg, Gg, Gg, Gg, Hh, Rp, Gg, Gs^Fds, Hh, Hh, Hh, Gg, Gg, Hh, Hh, Hh, Hh, Gg, Gg, Gg, Gg, Gg, Gg, Gg, Gg, Gg, Gg, Rd, Re, Gg, Gg, Gg, Gs^Fds, Gs^Fds, Hh, Gs^Fds, Gs^Fds, Gg, Gg, Gg, Hh, Hh
Gg, Gg, Hh, Hh, Rp, Re, Gg, Gg, Re, Rp, Rp, Gg, Gg, Gg, Gg, Gg, Gg, Gs^Fms, Gg, Gg, Gg, Gg, Gg, Gg, Gg, Gg, Gg, Rd, Gg, Gg, Gs^Fds, Gs^Fds, Hh, Hh, Gs^Fds, Gs^Fds, Gg, Gg, Hh, Hh, Gs^Fds, Gs^Fds
Gs^Fds, Gs^Fds, Gs^Fds, Gs^Fds, Rp, Rd, Gg, Gg, Gg, Gg, Re, Gg, Gg, Gg, Gg, Gg, Gg, Gg, Gg, Gg, Gs^Vh, Gg, Gg, Gg, Gg, Gg, Gg, Rp, Re, Gg, Gs^Fds, Hh, Hh, Hh, Gg, Gg, Gg, Gg, Hh, Gs^Fds, Gg, Gs^Fds
Gg, Gs^Fds, Gg, Gg, Re, Gg, Gg, Gg, Gg, Gg, Rp, Hh, Hh, Gg, Gg, Gg, Gg, Gg, Gg, Gg, Gg, Gg, Gg, Gg, Gg, Gg, Gg, Gg, Rd, Gg, Gg, Gg, Gg, Gg, Gg, Gg, Hh, Hh, Gs^Fds, Hh, Gg, Gg
Gg, Gg, Gg, Gg, Rp, Gg, Gg, Gg, Gg, Gg, Gg, Rp, Re, Hh, Gg, Gg, Gg, Gg, Gg, Gg, Gg, Gg, Gg, Gg, Gg, Gg, Hh, Gg, Gg, Rd, Re, Gg, Gg, Gg, Gg, Hh, Gs^Fds, Gs^Fds, Gg, Gg, Gg, Gg
Gg, Gg, Rd, Rp, Re, Gg, Gg, Gs^Vh, Gg, Gg, Gg, Rp, Re, Gg, Gs^Fds, Gg, Gs^Fds, Hh, Gg, Gg, Gg, Gg, Gg, Gg, Hh, Hh, Hh, Hh, Gg, Gs, Re, Gg, Gg, Gg, Hh, Gs^Fds, Gs^Fds, Gg, Gg, Gg, Gg, Gg
Gg, Gg, Gg, Rp, Re, Gg, Gg, Gg, Gg, Gg, Gg, Gs^Fds, Gs^Fds, Re, Gg, Gs^Fds, Gg, Gs^Fds, Gs^Fds, Gg, Gg, Gg, Hh, Hh, Hh, Hh, Gs^Fds, Gs^Fds, Rd, Rd, Gg, Gg, Gg, Hh, Gs^Fds, Gs^Fds, Hh, Gs^Fds, Gs^Fds, Gg, Gs^Fds, Gs^Fds
Gg, Gg, Gg, Rd, Gg, Gg, Gg, Gg, Gg, Gg, Gg, Gg, Gg, Gg, Gg, Rp, Re, Gg, Gg, Hh, Hh, Hh, Gg, Gg, Gg, Gs^Fds, Gs^Fds, Rd, Gg, Gg, Gg, Gs^Vh, Gg, Gg, Gg, Hh, Gg, Gs^Fds, Gs^Fds, Gs^Fds, Wwrg, Wwrt
Gg, Gg, Gg, Rp, Gg, Gg, Gg, Gg, Gg, Gg, Gg, Gg, Gg, Gg, Gg, Gg, Gg, Gg, Rp, Gg, Gg, Gg, Gg, Gg, Gg, Gg, Gg, Rd, Gg, Gg, Gg, Gg, Hh, Hh, Hh, Hh, Gg, Gs^Fds, Gs^Fds, Wwrg, Wwr, Wwrt
Gg, Gg, Gg, Rp, Gg, Hh, Gg, Gg, Gg, Gg, Gg, Gs, Gg, Gg, Gg, Gg, Gg, Re, Gg, Rp, Rp, Gg, Gs^Fds, Gg, Gg, Gg, Rd, Gg, Gg, Gg, Gg, Gg, Hh, Hh, Gs^Fds, Gs^Fds, Gg, Gg, Ww, Wwr, Gg, Gg
Gs^Fds, Gg, Gs^Fds, Gg, Gs^Fds, Gg, Gs^Fds, Gg, Gs^Fds, Gs^Fds, Hh, Gs, Hh, Gs^Fds, Gll^Fmf, Gg, Gg, Gg, Gg, Re, Rp, Gs^Fds, Gs^Vh, Gg, Gg, Gg, Rd, Gg, Gg, Gg, Gg, Gs^Fds, Gs^Fds, Gs^Fds, Gg, Gg, Gg, Ww, Gg, Gg, Gg, Gg
Gs^Fds, Gs^Fds, Gg, Gs^Fds, Gg, Gs^Fds, Gs^Fds, Gs^Fds, Gg, Gg, Gg, Gs, Gg, Gs^Fds, Gs^Fds, Gg, Gg, Gg, Gg, Gg, Re, Rp, Rp, Gg, Gg, Gg, Gg, Gg, Gg, Gg, Gg, Gs^Fds, Gs^Fds, Gs^Fds, Gg, Gg, Gg, Ww, Gg, Gg, Gg, Gg
Ww, Gs^Fds, Ww, Gg, Ww, Gs^Fds, Gs^Fds, Gs^Fds, Gs^Fds, Gg, Gg, Gg, Gg, Gg, Gs^Fds, Gg, Gg, Gg, Gg, Gg, Gg, Re, Re, Rp, Gg, Gg, Rd, Gg, Gg, Gg, Gg, Gg, Gg, Gg, Gg, Gg, Ww, Ww, Gg, Gg, Gg, Gg
Gg, Ww, Gs^Ft, Ww, Gs^Fds, Ww, Ww, Gg, Gg, Gg, Gg, Gg, Gg, Gg, Gg, Gg, Gg, Gg, Gg, Gg, Gg, Gg, Gg, Rp, Rp, Gg, Rd, Gg, Gg, Gg, Gg, Gg, Gg, Gg, Gg, Gg, Ww, Ww, Gg, Gg, Gg, Gg
Gs^Fds, Gs^Fds, Gs^Ft, Gs^Ft, Gs^Fds, Gg, Ww, Gg, Gg, Gg, Gg, Gg, Gg, Gs^Vh, Gg, Gs^Fds, Gg, Gg, Gg, Gg, Gg, Gg, Gg, Gs^Fds, Gs^Fds, Rp, Gs^Vh, Gg, Gg, Gg, Gg, Gg, Gg, Gg, Gg, Gg, Ww, Ww, Gg, Gg, Gg, Gg
Gs, Gs^Fds, Gs^Fds, Gs^Ft, Gs^Fds, Ww, Gs, Gg, Gg, Gg, Gg, Gg, Gg, Gg, Gg, Gg, Gg, Gg, Gg, Gg, Gg, Gg, Gg, Gg, Gg, Rp, Gg, Gg^Efm, Gg, Gg, Gg, Gg, Gg, Gg, Ww, Ww, Ww^Em, Gg, Gll, Gs^Fds, Gs^Fds, Gg
Gd^Fts, Gs, Gs, Gs^Fds, Gs^Ft, Ww, Ww, Gs, Gs, Gg, Gg, Gg, Gg, Gg, Gg, Gg, Gg, Gg, Gg, Gg, Gg, Gg, Gg, Gg, Gg, Rp, Gg, Gg, Gg, Gg, Gg, Gg, Gg, Gg, Ww, Ww^Em, Gg, Gg, Gll^Fdf, Gll^Fdf, Gs^Vh, Gs^Fds
Gll^Fmw, Gd^Fts, Gll^Fmw, Gs^Ft, Gs^Ftp, Gs^Ft, Ss, Wwr, Wog, Gs, Gg, Gd^Fts, Gs, Gg, Gg, Gg, Gg, Gg, Gg, Gg, Gg, Gg, Gg, Gg, Gg, Rp, Gg, Gg, Gg, Gg, Gg, Gg, Gg, Gg, Ww, Ww, Gg, Gg, Gg, Gg, Rd, Gg
Gd^Fts, Gll^Fmw, Gd^Fts, Gll^Fmw, Gd^Fts, Gd^Fts, Ss, Ss, Wog, Gs, Gs, Gd^Fts, Gd^Fts, Gs, Gd^Fetd, Gd^Fts, Gd^Fts, Gg, Gg, Gg, Gs^Fds, Gg, Rp, Rd, Gg, Gg, Gg, Gg, Gg, Gg, Gg, Gg, Gg, Gg, Ww, Gg, Gg, Gg, Gg, Gg, Gg, Rd
Gll^Fmw, Gd^Fts, Gs^Fms, Gd^Fts, Ss^Vhs, Ss, Wog, Wog, Ss, Ss, Gll^Ftr, Gs, Gll^Ftr, Gd^Fetd, Hhd^Vhhr, Gd^Fetd, Gd^Fts, Gs, Gg, Gg, Gg^Efm, Gs^Vh, Rp, Gg, Gg, Gg, Gg, Gg, Gg, Gg, Gg, Gg, Gg, Gg, Wwr, Gg, Gg, Gg, Gg, Gg, Gg, Gg
Gll^Ftr, Gd^Fts, Ss, Ss, Sm, Ss, Sm^Em, Sm^Em, Ss, Ss, Ss, Gll^Ftr, Ss, Gd^Fts, Rd, Rd, Rd, Gd^Fts, Rd, Gg, Rp, Rp, Gg, Gg, Gg, Gg, Gg, Gg, Gg, Gg, Gg, Gg, Gg, Gg, Wwr, Gg, Gg, Gg, Gg, Gg, Gg, Gg
Gll^Ftr, Ss, Ss, Ss, Wog, Sm, Chs, Ss, Ch, Chr, Ss, Ss, Rb, Ss^Bw/, Gd^Fts, Gs, Gs, Rd, Gg, Rd, Gs^Fds, Rd, Gg, Gg, Gg, Gg, Gg, Gg, Gg, Gg, Gg, Gg, Gg, Wwr, Wwrt, Gs^Fds, Gg, Gg, Gg, Gg, Gg, Gg
Gll^Ftr, Gll^Ftr, Gll^Ftr, Sm, Sm, Ss, Chs, Chs, Khs, Ch, Chr, Rb, Ss, Ss, Gd^Fts, Gd^Fts, Gs, Gg, Gg, Gg, Gg, Rd, Gg, Gg, Gg, Gg, Gg, Gg, Gg, Gg, Gg, Gg, Gs^Fds, Wwr, Wwrt, Gs^Fds, Wwrt, Gg, Gg, Gg, Gs^Fds, Gg
Sm, Gll^Ftr, Gll^Ftr, Sm^Em, Sm, Wog, Wog, Chs, Chs, Chs, Chs, Rb, Ss, Gd, Ss^Vhs, Gs, Gs, Gg, Gg, Gg, Gg, Gg, Gg, Gg, Gg, Gg, Gg, Gg, Gg, Gg, Gg, Gg, Gs^Fds, Wwr, Wwr, Wwrt, Wwrt, Ww, Ww, Gg, Gs^Fds, Gg
Gll^Ftr, Sm, Sm, Sm, Sm, Ss, Wog, Chs, Chs, Ss, Ss, Ss, Sm^Em, Ss, Gd^Fts, Gd^Fts, Gd^Fts, Gs, Gs, Gg, Gg, Rd, Gg, Gg, Gg, Gg, Gs^Fds, Gg, Gg, Gg, Gg, Gg, Gg, Gs^Fds, Gs^Fds, Wwr, Gs^Fds, Gs^Fds, Gs^Fds, Wwr, Wwr, Gs^Fds
Gll^Ftr, Gll^Ftr, Gll^Ftr, Gll^Ftr, Ss, Ss, Ss, Wog, Ss, Ss, Sm, Sm^Em, Ss, Ss, Gd^Fts, Gd^Fts, Gd^Fts, Gs, Rd, Rd, Rd, Rd, Rd, Gg, Gg, Gs^Fds, Gg, Gs^Fds, Gg, Gg, Gg, Gg, Gg, Gg, Gg, Gs^Fds, Gs^Fds, Gs^Fds, Gs^Fds, Gs^Fds, Ww, Ww
Ss, Ss, Sm, Sm, Ss, Rb, Rb, Ss, Ss, Ss, Ss, Ss, Ss, Ss, Ss, Gd^Fts, Gd^Fts, Gd^Fts, Rd, Gs^Fds, Gll^Fmw, Gg, Gg, Gg, Gg, Gg, Gg, Gg, Rd, Gg, Gg^Ve, Gg^Efm, Gg, Gg, Gg, Gg, Gg, Gs^Fds, Gs^Fds, Ss, Ww, Gg
Ss, Ss, Ss^Vhs, Ss, Gs^Ft, Gs^Ft, Gs, Sm^Em, Sm^Em, Ss, Wog, Sm, Ss, Sm, Ss, Ss, Rb, Rb, Gg, Gll^Fmf, Gll^Fmf, Gg, Gg, Gg, Gg, Gg, Gg, Gg, Gg, Rd, Rd, Rd, Rd, Gg, Gg, Gg, Gg, Gg, Gg, Ss, Ww, Gg
Wo, Ss, Gll^Ftr, Gs^Ft, Gll^Ftr, Gs^Ft, Ss, Ss, Ss, Ss, Wog, Ss, Gll^Ftr, Ss, Sm, Sm, Rb, Rb, Rb, Gs^Fds, Gs^Fds, Gg, Gg, Gg, Gg, Gg, Gg, Gg, Gg, Gg, Gg, Gg, Gg, Gg, Gg, Gg, Gg, Gg, Gg, Ww, Gg, Gg
Ss, Wo, Wo, Gll^Ftr, Gll^Ftr, Ss^Vhs, Chs, Chs, Sm, Sm^Em, Wog, Ss, Sm, Rb, Gll^Ftr, Gll^Ftr, Wwg, Ss, Ss, Ss, Sm, Gg, Gg, Gg, Gg, Gg, Gg, Gg, Gg, Gg, Gg, Gg, Gg, Gg, Gg, Rd, Rd, Gg, Ww, Ww, Gg, Gg
