Mm, Mm, Uue, Uue, Qxe, Uue, Mm, Mm, Hh, Hh, Mm, Mm, Mm, Mm, Mm, Mm, Mm^Xm, Mm^Xm, Mm, Mm, Mm, Mm, Mm^Xm, Mm^Xm, Mm, Mm^Xm, Mm, Mm^Xm, Mm^Xm, Mm^Xm, Mm^Xm, Mm^Xm, Mm^Xm, Mm^Xm, Mm^Xm, Mm^Xm, Mm^Xm, Mm^Xm, Mm^Xm, Mm^Xm, Mm^Xm, Mm, Mm^Xm, Ww, Ww^Es, Mm, Md^Xm, Mm, Gg, Mm, Mm, Mm, Mm, Mm, Gg, Hh, Mm, Hh, Gg, Mm, Mm, Mm, Md^Xm, Mm, Md^Xm, Md^Xm, Mm, Mm, Md^Xm, Mm, Mm, Mm, Mm, Mm, Mm, Mm, Mm, Mm, Mm, Mm, Mm, Mm, Mm, Hh
Gg, Hh, Re, Qxua, Uue, Uue, Mm, Hh, Mm, Mm, Mm, Mm, Mm, Mm, Mm^Xm, Mm^Xm, Mm^Xm, Mm^Xm, Mm, Mm, Mm^Xm, Mm^Xm, Mm, Mm, Mm, Mm, Mm, Mm, Mm, Mm^Xm, Mm^Xm, Mm^Xm, Mm^Xm, Mm^Xm, Mm^Xm, Mm^Xm, Mm^Xm, Mm^Xm, Mm, Mm^Xm, Mm, Mm^Xm, Gg, Gg, Gs^Fds, Wwr, Wo^Es, Gs^Fds, Md^Xm, Gg, Gg, Mm, Mm, Hh, Hh, Gg, Gg, Hh, Hh, Mm, Mm, Mm, Mm, Mm, Mm, Mm, Md^Xm, Mm, Mm, Md^Xm, Mm, Mm, Md^Xm, Md^Xm, Mm, Mm, Mm, Mm, Mm, Mm, Gs^Fms, Mm, Hh, Hh
Gg, Gs, Re, Re, Hh, Hh, Mm, Mm, Mm, Mm, Mm, Mm, Mm^Xm, Mm, Mm^Xm, Mm^Xm, Mm^Xm, Mm, Mm^Xm, Mm^Xm, Mm, Mm, Mm, Mm, Mm^Xm, Mm, Mm^Xm, Mm^Xm, Mm^Xm, Mm^Xm, Mm^Xm, Mm^Xm, Mm, Mm^Xm, Mm, Mm^Xm, Mm, Mm^Xm, Mm^Xm, Mm^Xm, Mm^Xm, Mm, Md^Xm, Gg, Gs^Fds, Wo^Es, Wo, Wo, Wo^Es, Md^Xm, Wwr, Gs^Fms, Hh, Hh, Hh, Gg, Gg, Rp, Rp, Mm, Mm, Mm, Hh, Mm, Mm, Mm, Md^Xm, Mm, Mm, Mm, Mm, Mm, Mm, Mm, Mm, Mm, Mm, Mm, Mm, Gs^Fms, Hh, Hh, Hh, Gs^Fms
Gg, Gg, Rb, Gg, Mm, Mm, Mm, Mm, Mm, Mm, Mm, Mm^Xm, Mm^Xm, Mm^Xm, Mm^Xm, Mm^Xm, Mm, Mm^Xm, Mm^Xm, Mm^Xm, Mm^Xm, Mm^Xm, Mm^Xm, Mm^Xm, Mm^Xm, Mm^Xm, Mm^Xm, Mm, Mm, Mm, Mm^Xm, Mm, Md^Xm, Mm, Mm, Mm, Mm, Mm, Mm, Mm, Mm, Mm^Xm, Mm, Mm, Gs^Fms, Md^Xm, Mm, Mm, Mm, Wwr, Ww^Es, Wo^Es, Wo, Wo, Wo^Es, Hh, Hh, Gg, Mm, Rp, Rp, Rp, Gs^Fms, Gs^Fms, Gs^Fms, Mm, Mm, Mm, Mm, Md^Xm, Gs^Fms, Mm, Gs^Fms, Mm, Gs^Fms, Mm, Mm, Mm, Hh, Hh, Gs^Fms, Gs^Fms, Gs^Fms, Gs^Fms
Gg, Gg, Rb, Gg, Mm, Mm, Mm, Mm, Gs^Fms, Mm, Gs^Fms, Mm, Mm, Mm, Mm, Mm, Gs^Fms, Mm, Gs^Fms, Mm, Gs^Fms, Mm, Mm, Mm, Mm, Mm, Mm, Mm^Xm, Mm^Xm, Mm^Xm, Mm^Xm, Mm, Mm, Mm, Mm, Mm, Gs^Fms, Mm, Md^Xm, Mm, Mm, Mm, Hh, Mm, Gs^Fms, Gs^Fms, Mm, Mm, Md^Xm, Gs^Fds, Mm, Gg, Gs^Fds, Sm, Wwr, Wo^Es, Mm, Mm, Mm, Mm, Rp, Gg, Mm, Gg, Gg, Gs^Fms, Mm, Mm, Hh, Gg, Gg, Gs^Fms, Mm, Gs^Fms, Gg, Gs^Fms, Gg, Gg, Gg, Gg, Gg, Gg, Gg, Gg
Gg, Gg, Rd, Gg, Gg, Mm, Mm, Mm, Gs^Fms, Gs^Fms, Mm, Gs^Fms, Gg, Mm, Mm, Mm, Hh, Mm, Hh, Gs^Fms, Mm, Mm, Mm, Hh, Mm, Mm, Mm, Mm, Mm, Gs^Fms, Mm, Gs^Fms, Gs^Fms, Mm, Mm, Gg, Gg, Gs^Fms, Gs^Fms, Mm, Mm, Mm, Mm, Mm, Hh, Gg, Gg, Mm, Mm, Mm, Mm, Mm, Mm, Ss, Ss, Wwr, Mm, Mm, Mm, Mm, Mm, Rp, Hh, Mm, Mm, Mm, Mm, Mm, Mm, Hh, Mm, Mm, Gg, Gg, Gs^Fds, Gg, Gg, Gg, Gg, Gg, Gg^Eff, Gg, Gg, Gg
Gg, Gg, Rd, Gg, Gg, Mm, Hh, Mm, Gg, Mm, Hh, Hh, Hh, Hh, Hh, Hh, Mm, Hh, Mm, Mm, Hh, Mm, Gg, Hh, Mm, Gg, Gg, Gg, Gg, Gg, Mm, Hh, Hh, Mm, Mm, Mm, Mm, Hh, Hh, Gg, Mm, Mm, Mm, Mm, Mm, Mm, Mm, Hh, Hh, Mm, Mm, Hh, Mm, Mm, Gg, Ww^Es, Gs^Fds, Gg, Gg, Mm, Hh, Gg, Gg, Hh, Hh, Hh, Gg, Mm, Mm, Hh, Gg, Gg, Gs^Fds, Gs^Fds, Gg, Gs^Fds, Gg, Gg, Gg^Eff, Gg^Eff, Gg^Gvs, Gg^Eff, Gg^Eff, Gg
Gg, Gg, Re, Rd, Gs^Fds, Gg, Hh, Hh, Gg, Hh, Hh, Gg, Gg, Mm, Mm, Mm, Gg, Gg, Gg, Mm, Hh, Gg, Hh, Mm, Mm, Mm, Gg, Mm, Mm, Hh, Mm, Mm, Mm, Mm, Mm, Mm, Mm, Mm, Mm, Mm, Ms^Xm, Mm, Mm, Mm, Gg, Gg, Gg, Mm, Gg, Hh, Gs^Fds, Hh, Gs^Fds, Gg, Gg, Ww, Ww, Gs^Fds, Hh, Hh, Hh, Gg, Gg, Hh, Gg, Hh, Hh, Gg, Gg, Gg, Gg, Gg, Gg, Gs^Fds, Gg, Gg, Gg, Gg, Gg^Gvs, Gg^Gvs, Gg^Gvs, Gg^Gvs, Gs^Vh, Gg^Eff
Gg, Gg, Gg, Re, Hh, Gs^Fds, Gg, Gg, Gg, Hh, Gg, Gg, Gg, Gg, Gs^Fds, Gg, Gg, Gg, Gg, Gg, Hh, Hh, Hh, Gg, Gg, Gg, Gg, Gg, Gg, Gg, Gg, Mm, Mm, Mm, Gg, Mm, Mm^Xm, Mm, Mm, Md^Xm, Md^Xm, Mm, Gg, Gg, Gg, Gg, Gg, Gs^Fds, Hh, Hh, Gg, Gg, Gg, Hh, Gg, Gg, Gg, Ww, Ww^Es, Wwr, Ww^Es, Ww, Ww, Gg, Gg, Gs^Fms, Gs^Fms, Gg, Gg, Gg, Gg, Gg, Rd, Gg, Rb, Rb, Gg, Rd, Gg^Eff, Gg^Gvs, Gg^Gvs, Gg^Gvs, Gg^Gvs, Gs
Gg, Gg, Gs^Fds, Gs^Fds, Gg, Gs^Fds, Re, Rb, Re, Gg, Rd, Gg, Re, Gg, Rd, Gg, Re, Gg, Re, Re, Re, Rd, Rd, Rd, Rd, Re, Re, Gg, Re, Gg, Gs^Fds, Gs^Fds, Hh, Gg, Gg, Gg, Gg, Mm, Gg, Gg, Gg, Gg, Gg, Gg, Gg, Gg, Gg, Gs^Fds, Gg, Gg, Gg, Gg, Gg, Gg, Gg, Gg, Gg, Gg, Gg, Ww^Es, Gg, Ww, Ww^Bw/r, Ww^Bw/r, Ww, Ss, Gs^Fms, Gs^Fms, Gg, Rb, Gg, Rd, Gg, Gg, Gg, Gg, Gg, Gg, Gg, Gg^Eff, Gg, Gg^Gvs, Gg^Gvs, Gs
Gg, Gg, Gs^Fds, Hh, Hh, Gg, Gg, Gg, Gg, Re, Rb, Rd, Rb, Rd, Hh, Gg, Gg, Rd, Gg, Gs^Fds, Gg, Gg, Gs^Fds, Gg, Gg, Rd, Gs^Fds, Rd, Rd, Hh, Hh, Gg, Hh, Hh, Gs^Fds, Gg, Gg, Gg, Re, Gg, Rd, Gg, Gg, Gg, Rb, Rb, Rd, Rd, Rd, Re, Rd, Re, Re, Rd, Rd, Rd, Rd, Gg, Rd, Rb, Rd, Rb, Gg, Ww, Ww, Ss, Ss, Wo, Wo, Gg, Ww^Es, Gg, Ww^Es, Gg, Gg, Gg, Gg, Gg, Hh, Gg, Gg, Gg, Gs^Fms, Gs
Gg, Gg, Gg, Gs^Fds, Gg, Gg, Gg, Gg, Gs^Fds, Gg, Gg, Gg, Gg, Gs^Fds, Hh, Gg, Gg, Gg, Gs^Fds, Gs^Fds, Hh, Hh, Hh, Gs^Fds, Hh, Gg, Gg, Gg, Gg, Rd, Gg, Rb, Gg, Gg, Gg, Gs^Fds, Hh, Hh, Hh, Hh, Hh, Re, Hh, Hh, Gg, Gg, Gg, Gg, Gg, Gg, Gs^Fds, Gg, Gg, Gg, Hh, Gg, Gs^Fds, Rd, Gg, Rd, Gg, Gg, Gg, Gg, Gs^Fms, Sm, Gs^Fms, Ss, Gg, Ww^Es, Gg, Wwr, Wwr, Ww^Es, Ww^Es, Gg, Gg, Gg, Hh, Gs^Fms, Hh, Gs^Fms, Gg, Gg
Gg, Gg, Gg, Gg, Gg, Gg, Gg, Hh, Gg, Gg, Gg, Gg, Gg, Gs^Fds, Gg, Gg, Gg, Gg, Gg, Gg, Gg, Gg, Gg, Gg, Gg, Gs^Fds, Gg, Gg, Gg, Gg, Gg, Gg, Gg, Gg, Gg, Gg, Gg, Gg, Gg, Gg, Gg, Gg, Gg, Gg, Gg, Gg, Gg, Gg, Gg, Gg, Gg, Gs^Fds, Gs^Fds, Hh, Gg, Hh, Gg, Gg, Gg, Gg, Gg, Gg, Gg, Gg, Gg, Gs^Fms, Gg, Gg, Gg, Gg, Gg, Gg, Gg, Gg, Gg, Ww, Ww, Gg, Ww, Hh, Ww^Ewl, Gg, Ww^Ewf, Ww
