Mm, Mm, Mm, Mm, Mm, Md^Xm, Md^Xm, Mm^Xm, Mm^Xm, Xue, Xue, Uu^Uf, Xue, Uh^Dr, Uh, Uue, Re, Ur, Rb^Dr, Uh^Dr, Xu, Uh^Dr, Uh^Es, Uu, Uu^Es, Uu^Es, Uu^Es, Uu, Uu, Uu, Xu, Uu, Xu, Xu, Xu, Xu, Xu, Xu, Xu, Xu, Md^Xm, Md^Xm, Md, Wo
Mm, Mm, Mm, Mm, Mm, Md^Xm, Md^Xm, Mm^Xm, Mm^Xm, Xue, Xue, Xue, Md^Xm, Xue, Xue, Uue, Rb, Rb, Uu^Es, Uh^Emf, Xu, Uh^Dr, Xu, Uh, Xu, Uh^Es, Xu, Xu, Xu, Xu, Xu, Xu, Xu, Xu, Xu, Xu, Xu, Xu, Xu, Xu, Md^Xm, Md^Xm, Gll, Wo
Mm, Mm, Mm, Mm, Mm, Md^Xm, Md^Xm, Md^Xm, Md^Xm, Xue, Md^Xm, Md^Xm, Gll^Fmf, Md^Xm, Re, Re, Xue, Xue, Xue, Xue, Xu, Xu, Xu, Xu, Xu, Xu, Xu, Xu, Xu, Xu, Xu, Xu, Xu, Xu, Xu, Xu, Xu, Xu, Xu, Xu, Md^Xm, Rb, Ww, Wo
Mm, Mm, Mm, Md^Xm, Md^Xm, Md^Xm, Md, Md^Xm, Md, Md, Gll, Gll, Gll^Fmf, Gll, Re, Hhd, Md^Xm, Xue, Xue, Xue, Xu, Xu, Xu, Xu, Xu, Xu, Xu, Xu, Xu, Xu, Xu, Xu, Xu, Xu, Xu, Xu, Xu, Xu, Xu, Xu, Md^Xm, Ww, Wo, Wo
Mm, Mm, Mm, Md^Xm, Mm, Md, Md, Md, Md, Md, Md, Md, Gll, Gll, Rp, Hhd, Hhd, Md^Xm, Md^Xm, Md^Xm, Md^Xm, Xu, Mm^Xm, Xu, Mm^Xm, Xu, Mm^Xm, Xu, Mm^Xm, Xu, Md^Xm, Xu, Md^Xm, Xu, Md^Xm, Xu, Md^Xm, Xu, Md^Xm, Xu, Md^Xm, Ww, Rb, Md
Mm, Mm, Md^Xm, Md^Xm, Mm, Md^Xm, Mm, Md, Md, Md, Gll, Gll^Fmf, Hhd, Hhd, Rp, Md, Md, Md, Md, Gll^Fmf, Md, Md^Xm, Md^Xm, Mm^Xm, Md^Xm, Mm^Xm, Md^Xm, Md^Xm, Md^Xm, Md^Xm, Md^Xm, Md^Xm, Md^Xm, Md^Xm, Md^Xm, Md^Xm, Md^Xm, Md^Xm, Md^Xm, Md^Xm, Wo, Wo, Rb, Md
Mm, Mm, Md^Xm, Md^Xm, Mm, Md^Xm, Mm, Md^Xm, Md^Xm, Md^Xm, Gll^Fmf, Md, Md, Gll, Rp, Gll, Gll, Hhd, Md, Gll, Gll, Md, Gll^Fmf, Md^Xm, Md, Md^Xm, Md^Xm, Md^Xm, Md^Xm, Md^Xm, Md^Xm, Md^Xm, Md^Xm, Md^Xm, Md^Xm, Md^Xm, Md^Xm, Md^Xm, Ww, Md^Xm, Wo, Rb, Gll^Fmf, Md
Mm, Mm, Md^Xm, Mm, Mm, Mm, Mm, Mm, Mm, Md, Md, Md, Gll, Md, Gll^Fmf, Md, Gll, Rp, Rp, Hhd, Rp, Gll^Fmf, Gll, Md, Gll, Gll^Fmf, Md, Md^Xm, Md^Xm, Md^Xm, Md^Xm, Md^Xm, Md^Xm, Md^Xm, Md^Xm, Md^Xm, Md^Xm, Md^Xm, Ww, Ww, Md, Gll^Fmf, Gll, Md
Mm, Mm, Md^Xm, Mm, Mm, Mm, Mm, Mm, Mm, Mm, Md^Xm, Md, Md, Gll, Md, Hhd, Rp, Rp, Gll, Hhd, Hhd, Rp, Rp, Rp, Rp, Gll, Gll, Md, Md, Md^Xm, Mm, Mm, Mm, Md^Xm, Mm, Md^Xm, Md^Xm, Md^Xm, Ww, Rb, Gll^Fmf, Md, Md, Md
Mm^Xm, Mm, Mm, Md^Xm, Mm, Mm, Md^Xm, Md^Xm, Mm, Md^Xm, Md^Xm, Md, Md, Gll, Md, Hhd, Md, Gll, Md, Md, Md, Md, Gll, Rp, Gll, Md, Gll, Gll^Fmf, Md, Mm, Mm, Mm, Mm, Mm, Mm, Mm, Mm, Md^Xm, Wo, Rb, Gll^Fmf, Gll, Md, Mm
Mm^Xm, Mm^Xm, Mm, Md^Xm, Mm, Mm, Md^Xm, Mm, Mm, Mm, Md^Xm, Md, Md, Md, Md, Mm, Md, Md, Md, Md, Gll^Fmf, Md, Gll, Md, Gll, Hhd, Hhd, Gll^Fmf, Gll^Fmf, Md, Mm, Mm, Mm, Mm, Mm, Mm, Md, Md^Xm, Wo, Gll^Fmf, Md, Gll, Md^Xm, Mm
Mm, Mm^Xm, Mm^Xm, Md^Xm, Md^Xm, Mm, Md^Xm, Md^Xm, Md^Xm, Md^Xm, Mm, Md^Xm, Md^Xm, Md, Md^Xm, Md, Mm, Md, Md, Gll^Fmf, Gll^Fmf, Gll, Md, Md, Gg, Gg, Md, Hhd, Gll^Fmf, Md, Mm, Mm, Md^Xm, Mm, Mm, Md, Rb, Md^Xm, Wo, Md, Md, Md, Mm, Md^Xm
Mm^Xm, Mm, Mm^Xm, Mm, Mm, Md^Xm, Mm, Mm, Mm, Mm, Mm, Md^Xm, Mm, Md^Xm, Md^Xm, Md^Xm, Mm, Md, Md, Gll, Gll^Fmf, Md, Md, Mm, Gg, Gg, Md, Hhd, Md, Md, Mm, Md^Xm, Md^Xm, Md^Xm, Md, Md, Gll^Fmf, Rb, Ww, Wo, Mm, Mm, Mm, Mm
Mm^Xm, Mm^Xm, Mm^Xm, Mm, Mm, Md^Xm, Mm, Mm, Mm, Mm, Mm, Mm, Mm, Mm, Mm, Md^Xm, Mm, Md, Md, Gll^Fmf, Gll, Gll, Gg, Gg, Md, Md, Mm, Md, Mm, Mm, Md^Xm, Md^Xm, Mm, Md^Xm, Md, Gll, Gll, Gll^Fmf, Wo, Wo, Mm, Mm, Mm, Mm
Mm^Xm, Mm^Xm, Mm, Mm, Md^Xm, Md^Xm, Mm, Mm, Md^Xm, Md^Xm, Mm, Md^Xm, Mm, Mm, Md^Xm, Md^Xm, Md^Xm, Md, Gll, Gll, Hhd, Hhd, Hhd, Hhd, Gll^Fmf, Gll^Fmf, Md^Xm, Mm, Mm, Md^Xm, Mm, Mm, Mm, Md^Xm, Mm, Md, Md^Xm, Md^Xm, Md^Xm, Wo, Wo, Mm, Md^Xm, Mm
Mm^Xm, Mm^Xm, Mm^Xm, Mm^Xm, Md^Xm, Mm, Mm, Mm, Mm, Mm, Md^Xm, Mm, Mm, Md^Xm, Mm, Md^Xm, Md^Xm, Md, Md, Gll, Gg, Gg, Gll, Gll^Fmf, Gll^Fmf, Md^Xm, Md^Xm, Mm, Mm, Mm, Md^Xm, Mm, Md^Xm, Md^Xm, Mm, Mm, Md, Md^Xm, Gll^Fmf, Wo, Wo, Md^Xm, Md^Xm, Md^Xm
Mm, Mm^Xm, Mm, Mm^Xm, Md^Xm, Mm, Mm, Mm, Mm, Mm, Md^Xm, Mm, Mm, Mm, Mm, Md^Xm, Md^Xm, Mm, Md, Gll, Gs^Fms, Gg, Rp, Gll, Gs^Fms, Md^Xm, Md^Xm, Md^Xm, Md^Xm, Mm, Mm, Mm, Mm, Mm, Mm, Mm, Md, Gll, Gll^Fmf, Rb, Ww, Wo, Rb, Md^Xm
Mm^Xm, Mm^Xm, Mm^Xm, Mm, Md^Xm, Mm, Mm, Md^Xm, Mm, Mm, Mm, Mm, Mm, Mm, Mm, Mm, Md^Xm, Mm, Mm, Md, Gs^Fms, Mm, Gg, Rp, Mm, Gs^Fms, Mm, Mm, Mm, Md^Xm, Md^Xm, Mm, Mm, Mm, Mm, Mm, Md, Gll, Gll^Fmf, Rb, Ww, Wo, Gll^Fmf, Md^Xm
Mm^Xm, Mm, Mm, Md^Xm, Mm, Mm, Md^Xm, Mm, Mm, Mm, Md^Xm, Mm, Mm, Md^Xm, Md, Mm, Md, Md^Xm, Md, Md, Gll^Fmf, Md, Md, Rp, Rp, Gll, Md, Mm, Md, Mm, Mm, Md^Xm, Md^Xm, Md^Xm, Mm, Mm, Md^Xm, Md^Xm, Gll^Fmf, Rb, Rb, Wo, Wo, Md^Xm
Mm^Xm, Mm^Xm, Md^Xm, Md^Xm, Mm, Md^Xm, Mm, Mm, Md^Xm, Mm, Mm, Mm, Md, Md, Gll^Fmf, Md, Gll^Fmf, Md, Md, Md, Gs^Fms, Md, Mm, Mm, Rp, Md, Gll^Fmf, Gll^Fmf, Md, Mm, Md, Md, Md, Md^Xm, Md^Xm, Md^Xm, Md, Md^Xm, Gll, Md, Gll^Fmf, Gll^Fmf, Wo, Md^Xm
Mm^Xm, Mm^Xm, Mm, Md^Xm, Md^Xm, Mm, Mm, Mm, Mm, Mm, Mm, Mm, Gg, Gll^Fmf, Gs^Fms, Md, Gs^Fms, Md, Md, Md, Md, Gs^Fms, Mm, Mm, Rp, Md, Md, Md, Md, Md, Md, Md, Mm, Md^Xm, Mm, Md, Gll, Gll, Gll^Fmf, Gll, Md, Md, Ww, Md^Xm
Mm, Mm, Mm, Mm, Md^Xm, Mm, Mm, Md^Xm, Mm, Mm, Mm, Gg, Mm, Mm, Mm, Md, Hhd, Hh, Hh, Md, Gg, Hhd, Rp, Mm, Rp, Md, Gll^Fmf, Md, Md, Md, Md^Xm, Mm, Mm, Mm, Mm, Md, Gll, Gll^Fmf, Rb, Rb, Ww, Ww, Md^Xm, Md^Xm
Mm, Mm, Mm, Mm, Md^Xm, Mm, Mm, Md^Xm, Mm, Mm, Gg, Mm, Hhd, Mm, Rp, Hhd, Rp, Gg, Rp, Rp, Rp, Rp, Gg, Rp, Md, Md, Gs^Fms, Md, Md^Xm, Md^Xm, Md^Xm, Md^Xm, Md^Xm, Mm, Mm, Md, Rb, Rb, Ww, Ww, Ww, Md^Xm, Mm, Md^Xm
Mm, Mm, Md^Xm, Md^Xm, Mm, Mm, Mm, Md^Xm, Gll, Gs^Fms, Md, Hhd, Gg, Rp, Mm, Mm, Mm, Rp, Gg, Gg, Gll, Mm, Mm, Hh, Gll^Fmf, Md, Mm, Mm, Mm, Mm, Mm, Mm, Mm, Md^Xm, Mm, Md, Ww, Ww, Gll^Fmf, Md, Md^Xm, Mm, Mm, Mm
Mm, Mm, Md^Xm, Mm, Mm, Mm, Md^Xm, Md^Xm, Gll, Gs^Fms, Gll^Fmf, Md, Hhd, Rp, Rp, Mm, Gg, Gg, Gll, Md, Mm, Mm, Mm, Md, Md, Hh, Mm, Mm, Mm, Mm, Mm, Mm, Mm, Mm, Md^Xm, Md^Xm, Wo, Wo, Md^Xm, Md^Xm, Md^Xm, Md^Xm, Md^Xm, Md^Xm
Mm, Md^Xm, Mm, Mm, Mm, Mm, Mm, Mm, Md, Gll^Fmf, Gll^Fmf, Hhd, Hh, Gg, Gg, Mm, Gs^Fms, Gs^Fms, Gll^Fmf, Md^Xm, Md^Xm, Mm, Mm, Mm, Md^Xm, Mm, Mm, Mm, Md^Xm, Mm, Mm, Md^Xm, Mm, Mm, Ww, Md, Wo, Wo, Md^Xm, Mm, Mm, Mm, Mm, Md^Xm
Mm, Md^Xm, Mm, Md^Xm, Mm, Mm, Mm, Mm, Mm, Md, Hh, Hh, Mm, Mm, Gg, Mm, Mm, Md, Gll, Gll^Fmf, Md, Md^Xm, Mm, Md^Xm, Mm, Md^Xm, Md^Xm, Md^Xm, Md^Xm, Mm, Mm, Md^Xm, Ww, Ww, Wo, Wo, Ww, Md^Xm, Md^Xm, Md^Xm, Mm, Mm, Md^Xm, Md^Xm
Mm, Md^Xm, Md^Xm, Mm, Mm, Mm, Md^Xm, Md^Xm, Mm, Mm, Hhd, Hhd, Mm, Mm, Gg, Gg, Gg, Rp, Md, Gll, Md, Md, Mm, Mm, Mm, Md^Xm, Mm, Md^Xm, Mm, Md^Xm, Wo, Wo, Ww, Wo, Gg, Gll^Fmf, Rb, Ww, Md^Xm, Mm, Mm, Mm, Md^Xm, Md^Xm
Mm^Xm, Mm, Md^Xm, Mm, Mm, Mm, Md^Xm, Mm, Mm, Mm, Mm, Gs^Fms, Gs^Fms, Gs^Fms, Gs^Fms, Gg, Gg, Rp, Md, Hhd, Gll, Md, Md, Mm, Mm, Md^Xm, Mm, Mm, Mm, Mm, Wo, Ww, Ww, Gg, Md, Md, Md, Ww, Md^Xm, Mm, Md^Xm, Md^Xm, Mm, Mm
Mm, Mm^Xm, Md^Xm, Mm, Mm, Mm, Mm, Mm, Mm, Mm, Mm, Mm, Mm, Gs^Fms, Gs^Fms, Gg, Hh, Gg, Rp, Hhd, Md, Md, Gs^Fms, Md^Xm, Md^Xm, Md^Xm, Md^Xm, Mm, Ww, Ww, Ww, Ww, Ww, Gs^Fms, Md^Xm, Md, Ww, Ww, Md^Xm, Md^Xm, Mm, Mm, Mm, Mm
Mm, Mm^Xm, Mm^Xm, Mm, Mm, Mm, Md^Xm, Mm, Mm, Md^Xm, Mm, Mm, Mm, Gg, Gg, Gg, Hh, Gg, Rp, Gg, Mm, Mm, Gs^Fms, Mm, Mm, Md^Xm, Ww, Ww, Ww, Gg, Gg, Ww, Ww, Gs^Fms, Md^Xm, Md^Xm, Ww, Mm, Md^Xm, Md^Xm, Md^Xm, Mm, Mm, Mm
Mm, Mm^Xm, Md^Xm, Mm, Mm, Mm, Md^Xm, Mm, Mm, Md^Xm, Md^Xm, Mm, Mm, Mm, Mm, Gg, Mm, Hh, Gg, Mm, Mm, Gs^Fms, Gg, Gg, Ww, Ww, Gs^Fms, Gs^Fms, Md^Xm, Md^Xm, Mm, Gs^Fms, Gs^Fms, Ww, Gg, Gs^Fms, Ww, Md^Xm, Md^Xm, Mm, Mm, Mm, Mm, Gs^Fms
Mm^Xm, Mm^Xm, Mm, Md^Xm, Md^Xm, Mm, Mm, Mm, Mm, Mm, Md^Xm, Md^Xm, Md^Xm, Mm, Mm, Mm, Mm, Mm, Mm, Gg, Rp, Gs^Fms, Ww, Ww, Hh, Gg, Gg, Gg, Mm, Mm, Md^Xm, Mm, Gg, Ww, Ww, Gg, Ww, Gg, Md^Xm, Mm, Mm, Mm, Hh, Hh^Vhh
Mm^Xm, Mm^Xm, Mm, Md^Xm, Md^Xm, Mm, Mm, Mm, Md^Xm, Md^Xm, Mm, Md^Xm, Md^Xm, Mm, Mm, Mm, Ww, Mm, Ww, Hh, Ww, Rp, Rp, Ww, Mm, Hh, Hh, Mm, Mm, Mm, Mm, Mm, Md^Xm, Gg, Ww, Ww, Ww, Md^Xm, Md^Xm, Mm, Mm, Md^Xm, Hh, Gg
Mm^Xm, Mm, Md^Xm, Md^Xm, Md^Xm, Md^Xm, Md^Xm, Md^Xm, Mm, Mm, Mm, Mm, Mm, Md^Xm, Md^Xm, Ww, Ww, Ww, Ww, Ww, Ww, Ww, Gg, Rp, Gg, Mm, Hh, Hh, Hh, Mm, Mm, Mm, Md^Xm, Gs^Fms, Gs^Fms, Ww, Ww, Ww, Ww, Md^Xm, Gg, Gg, Gg, Mm
Mm^Xm, Md^Xm, Md^Xm, Mm, Mm, Mm, Mm, Mm, Mm, Mm, Mm, Mm, Gs^Fms, Gs^Fms, Ww, Ww, Md^Xm, Mm, Mm, Ww, Mm, Hh, Mm, Gg, Gg, Gg, Gg, Hh, Mm, Mm, Mm, Mm, Md^Xm, Gg, Gg, Md^Xm, Mm, Ww, Ww, Ww, Ww, Wwr, Ww^Es, Ww
Md^Xm, Mm, Md^Xm, Mm, Mm, Mm, Md^Xm, Md^Xm, Md^Xm, Mm, Mm, Md^Xm, Gg, Ww, Mm, Mm, Mm, Md^Xm, Md^Xm, Mm, Mm, Mm, Mm, Mm, Mm, Rp, Mm, Gg, Mm, Mm, Mm, Mm, Md^Xm, Mm, Mm, Mm, Md^Xm, Mm, Gg, Gg, Ww, Ww^Es, Mm, Mm
Mm, Md^Xm, Md^Xm, Mm, Mm, Mm, Mm, Md^Xm, Wo, Md^Xm, Wo, Gg, Ww, Ww, Mm, Mm, Mm, Mm, Mm, Mm, Mm, Mm, Mm, Mm, Mm, Rp, Gg, Gg, Mm, Mm, Mm, Mm, Mm, Mm, Mm, Mm, Md^Xm, Md^Xm, Md^Xm, Gs^Fms, Mm, Mm, Mm, Mm
Mm, Md^Xm, Md^Xm, Mm, Gg, Wo, Wo, Wo, Ww, Wo, Ww, Ww, Mm, Hh, Hh, Hh, Mm, Mm, Mm, Mm, Mm, Mm, Mm, Mm, Gg, Rp, Gg, Gg, Hh, Mm, Mm, Mm, Mm, Mm, Mm, Mm, Mm, Md^Xm, Mm, Mm, Mm, Mm, Hh, Mm
Mm, Md^Xm, Md^Xm, Mm, Gg, Gs^Fms, Wo, Ww, Mm, Ww, Mm, Mm, Mm, Hh, Mm, Hh, Gg, Mm, Gg, Gg, Hh, Hh, Hh, Gg, Hh, Gg, Hh, Hh, Mm, Hh, Hh, Mm, Mm, Mm, Md^Xm, Mm, Mm, Md^Xm, Mm, Mm, Mm, Hh, Mm, Mm
Mm^Xm, Mm, Md^Xm, Mm, Mm, Gs^Fms, Wo, Md^Xm, Mm, Mm, Mm, Mm, Hh, Hh, Gg, Gg, Rp, Rp, Mm, Rp, Hh, Gg, Hh, Hh, Mm, Mm, Mm, Mm, Mm, Mm, Mm, Mm, Md^Xm, Mm, Mm, Mm, Mm, Md^Xm, Mm, Mm, Mm, Hh, Hh, Mm
Mm^Xm, Md^Xm, Mm, Mm, Gs^Fms, Gs^Fms, Wo, Md^Xm, Mm, Mm, Mm, Mm, Hh, Hh, Gg, Rp, Mm, Mm, Mm, Mm, Hh, Hh, Mm, Mm, Mm, Mm, Mm, Mm, Md^Xm, Md^Xm, Mm, Mm, Mm, Mm, Mm, Mm, Mm, Md^Xm, Md^Xm, Mm, Mm, Mm, Mm, Mm
Mm^Xm, Mm^Xm, Mm, Md^Xm, Gs^Fms, Wo, Wo, Md^Xm, Mm, Mm, Mm, Mm, Mm, Gg, Re, Mm, Mm, Mm, Mm, Mm, Mm, Hh, Mm, Mm, Mm, Mm, Md^Xm, Md^Xm, Mm, Mm, Mm, Mm, Mm, Mm, Mm, Mm, Mm, Mm, Md^Xm, Mm, Mm, Mm, Mm, Mm
Mm, Md^Xm, Mm, Mm, Ww, Wo, Ww, Md^Xm, Mm, Mm, Mm, Mm, Mm, Gg, Gg, Hh, Hh, Mm, Mm, Mm, Mm, Mm, Md^Xm, Mm, Md^Xm, Mm, Mm, Mm, Mm, Mm, Mm, Mm, Md^Xm, Mm, Md^Xm, Md^Xm, Md^Xm, Mm, Md^Xm, Mm, Mm, Mm, Mm, Mm
Mm^Xm, Mm^Xm, Mm^Xm, Mm^Xm, Mm^Xm, Wo, Ww, Md^Xm, Md^Xm, Mm, Mm, Mm, Hh, Hh, Gg, Mm, Mm, Mm, Mm, Mm, Mm, Mm, Mm, Md^Xm, Mm, Md^Xm, Md^Xm, Md^Xm, Md^Xm, Md^Xm, Md^Xm, Md^Xm, Mm, Md^Xm, Md^Xm, Mm, Mm, Md^Xm, Mm, Mm, Mm, Mm, Mm, Mm
Mm, Mm, Mm, Mm, Mm^Xm, Ww, Md^Xm, Mm, Mm, Mm, Mm, Mm, Mm, Hh, Mm, Gg, Gg, Hh, Mm, Mm, Hh, Mm, Mm, Md^Xm, Mm, Mm, Mm, Mm, Mm, Mm, Mm, Mm, Md^Xm, Mm, Mm, Mm, Md^Xm, Mm, Mm, Mm, Mm, Mm, Mm, Mm
Mm^Xm, Mm^Xm, Mm^Xm, Mm, Mm^Xm, Ww, Ww^Es, Mm, Md^Xm, Mm, Gg, Mm, Mm, Mm, Mm, Mm, Gg, Hh, Mm, Hh, Gg, Mm, Mm, Mm, Md^Xm, Mm, Md^Xm, Md^Xm, Mm, Mm, Md^Xm, Mm, Mm, Mm, Mm, Mm, Mm, Mm, Mm, Mm, Mm, Mm, Mm, Mm
Mm, Mm^Xm, Mm, Mm^Xm, Gg, Gg, Gs^Fds, Wwr, Wo^Es, Gs^Fds, Md^Xm, Gg, Gg, Mm, Mm, Hh, Hh, Gg, Gg, Hh, Hh, Mm, Mm, Mm, Mm, Mm, Mm, Mm, Md^Xm, Mm, Mm, Md^Xm, Mm, Mm, Md^Xm, Md^Xm, Mm, Mm, Mm, Mm, Mm, Mm, Gs^Fms, Mm
Mm^Xm, Mm^Xm, Mm^Xm, Mm, Md^Xm, Gg, Gs^Fds, Wo^Es, Wo, Wo, Wo^Es, Md^Xm, Wwr, Gs^Fms, Hh, Hh, Hh, Gg, Gg, Rp, Rp, Mm, Mm, Mm, Hh, Mm, Mm, Mm, Md^Xm, Mm, Mm, Mm, Mm, Mm, Mm, Mm, Mm, Mm, Mm, Mm, Mm, Gs^Fms, Hh, Hh
Mm, Mm, Mm, Mm^Xm, Mm, Mm, Gs^Fms, Md^Xm, Mm, Mm, Mm, Wwr, Ww^Es, Wo^Es, Wo, Wo, Wo^Es, Hh, Hh, Gg, Mm, Rp, Rp, Rp, Gs^Fms, Gs^Fms, Gs^Fms, Mm, Mm, Mm, Mm, Md^Xm, Gs^Fms, Mm, Gs^Fms, Mm, Gs^Fms, Mm, Mm, Mm, Hh, Hh, Gs^Fms, Gs^Fms
Md^Xm, Mm, Mm, Mm, Hh, Mm, Gs^Fms, Gs^Fms, Mm, Mm, Md^Xm, Gs^Fds, Mm, Gg, Gs^Fds, Sm, Wwr, Wo^Es, Mm, Mm, Mm, Mm, Rp, Gg, Mm, Gg, Gg, Gs^Fms, Mm, Mm, Hh, Gg, Gg, Gs^Fms, Mm, Gs^Fms, Gg, Gs^Fms, Gg, Gg, Gg, Gg, Gg, Gg
Gs^Fms, Mm, Mm, Mm, Mm, Mm, Hh, Gg, Gg, Mm, Mm, Mm, Mm, Mm, Mm, Ss, Ss, Wwr, Mm, Mm, Mm, Mm, Mm, Rp, Hh, Mm, Mm, Mm, Mm, Mm, Mm, Hh, Mm, Mm, Gg, Gg, Gs^Fds, Gg, Gg, Gg, Gg, Gg, Gg^Eff, Gg
Hh, Gg, Mm, Mm, Mm, Mm, Mm, Mm, Mm, Hh, Hh, Mm, Mm, Hh, Mm, Mm, Gg, Ww^Es, Gs^Fds, Gg, Gg, Mm, Hh, Gg, Gg, Hh, Hh, Hh, Gg, Mm, Mm, Hh, Gg, Gg, Gs^Fds, Gs^Fds, Gg, Gs^Fds, Gg, Gg, Gg^Eff, Gg^Eff, Gg^Gvs, Gg^Eff
Mm, Mm, Ms^Xm, Mm, Mm, Mm, Gg, Gg, Gg, Mm, Gg, Hh, Gs^Fds, Hh, Gs^Fds, Gg, Gg, Ww, Ww, Gs^Fds, Hh, Hh, Hh, Gg, Gg, Hh, Gg, Hh, Hh, Gg, Gg, Gg, Gg, Gg, Gg, Gs^Fds, Gg, Gg, Gg, Gg, Gg^Gvs, Gg^Gvs, Gg^Gvs, Gg^Gvs
Mm, Md^Xm, Md^Xm, Mm, Gg, Gg, Gg, Gg, Gg, Gs^Fds, Hh, Hh, Gg, Gg, Gg, Hh, Gg, Gg, Gg, Ww, Ww^Es, Wwr, Ww^Es, Ww, Ww, Gg, Gg, Gs^Fms, Gs^Fms, Gg, Gg, Gg, Gg, Gg, Rd, Gg, Rb, Rb, Gg, Rd, Gg^Eff, Gg^Gvs, Gg^Gvs, Gg^Gvs
Gg, Gg, Gg, Gg, Gg, Gg, Gg, Gg, Gg, Gs^Fds, Gg, Gg, Gg, Gg, Gg, Gg, Gg, Gg, Gg, Gg, Gg, Ww^Es, Gg, Ww, Ww^Bw/r, Ww^Bw/r, Ww, Ss, Gs^Fms, Gs^Fms, Gg, Rb, Gg, Rd, Gg, Gg, Gg, Gg, Gg, Gg, Gg, Gg^Eff, Gg, Gg^Gvs
Re, Gg, Rd, Gg, Gg, Gg, Rb, Rb, Rd, Rd, Rd, Re, Rd, Re, Re, Rd, Rd, Rd, Rd, Gg, Rd, Rb, Rd, Rb, Gg, Ww, Ww, Ss, Ss, Wo, Wo, Gg, Ww^Es, Gg, Ww^Es, Gg, Gg, Gg, Gg, Gg, Hh, Gg, Gg, Gg
Hh, Hh, Hh, Re, Hh, Hh, Gg, Gg, Gg, Gg, Gg, Gg, Gs^Fds, Gg, Gg, Gg, Hh, Gg, Gs^Fds, Rd, Gg, Rd, Gg, Gg, Gg, Gg, Gs^Fms, Sm, Gs^Fms, Ss, Gg, Ww^Es, Gg, Wwr, Wwr, Ww^Es, Ww^Es, Gg, Gg, Gg, Hh, Gs^Fms, Hh, Gs^Fms
Gg, Gg, Gg, Gg, Gg, Gg, Gg, Gg, Gg, Gg, Gg, Gg, Gg, Gs^Fds, Gs^Fds, Hh, Gg, Hh, Gg, Gg, Gg, Gg, Gg, Gg, Gg, Gg, Gg, Gs^Fms, Gg, Gg, Gg, Gg, Gg, Gg, Gg, Gg, Gg, Ww, Ww, Gg, Ww, Hh, Ww^Ewl, Gg
