Mm, Mm, Mm, Mm, Mm, Md^Xm, Md^Xm, Mm^Xm, Mm^Xm, Xue, Xue, Uu^Uf, Xue, Uh^Dr, Uh, Uue, Re, Ur, Rb^Dr, Uh^Dr, Xu, Uh^Dr, Uh^Es, Uu, Uu^Es, Uu^Es, Uu^Es, Uu, Uu, Uu, Xu, Uu, Xu, Xu, Xu, Xu, Xu, Xu, Xu, Xu, Md^Xm, Md^Xm, Mm, Mm
Mm, Mm, Mm, Mm, Mm, Md^Xm, Md^Xm, Mm^Xm, Mm^Xm, Xue, Xue, Xue, Mm^Xm, Xue, Xue, Uue, Rb, Rb, Uu^Es, Uh^Emf, Xu, Uh^Dr, Xu, Uh, Xu, Uh^Es, Xu, Xu, Xu, Xu, Xu, Xu, Xu, Xu, Xu, Xu, Xu, Xu, Xu, Xu, Md^Xm, Md^Xm, Mm, Mm
Mm, Mm, Mm, Mm, Mm, Md^Xm, Md^Xm, Md^Xm, Md^Xm, Xue, Mm^Xm, Mm^Xm, Mm, Mm^Xm, Re, Re, Xue, Xue, Xue, Xue, Xu, Xu, Xu, Xu, Xu, Xu, Xu, Xu, Xu, Xu, Xu, Xu, Xu, Xu, Xu, Xu, Xu, Xu, Xu, Xu, Md^Xm, Md^Xm, Mm, Mm
Mm, Mm, Mm, Md^Xm, Md^Xm, Md^Xm, Mm, Md^Xm, Mm, Mm, Mm, Mm, Mm, Gg, Re, Hh, Mm^Xm, Xue, Xue, Xue, Xu, Xu, Xu, Xu, Xu, Xu, Xu, Xu, Xu, Xu, Xu, Xu, Xu, Xu, Xu, Xu, Xu, Xu, Xu, Xu, Md^Xm, Md^Xm, Mm, Mm
Mm, Mm, Mm, Md^Xm, Mm, Mm, Mm, Mm, Mm, Mm, Mm, Mm, Mm, Gg, Gg, Hh, Hh, Mm^Xm, Mm^Xm, Mm^Xm, Mm^Xm, Xu, Mm^Xm, Xu, Mm^Xm, Xu, Mm^Xm, Xu, Mm^Xm, Xu, Md^Xm, Xu, Md^Xm, Xu, Md^Xm, Xu, Md^Xm, Xu, Md^Xm, Xu, Md^Xm, Md^Xm, Mm, Mm
Mm, Mm, Md^Xm, Md^Xm, Mm, Md^Xm, Mm, Mm, Mm, Mm, Md^Xm, Mm, Hh, Hh, Gg, Mm, Mm, Mm, Mm, Mm^Xm, Mm, Mm^Xm, Mm^Xm, Mm^Xm, Md^Xm, Mm^Xm, Md^Xm, Md^Xm, Md^Xm, Md^Xm, Md^Xm, Md^Xm, Md^Xm, Md^Xm, Md^Xm, Md^Xm, Md^Xm, Md^Xm, Md^Xm, Md^Xm, Md^Xm, Md^Xm, Mm, Mm
Mm, Mm, Md^Xm, Md^Xm, Mm, Md^Xm, Mm, Md^Xm, Md^Xm, Md^Xm, Mm, Mm, Mm, Hh, Mm, Gg, Gg, Hh, Mm, Mm, Hh, Mm, Mm, Mm^Xm, Mm, Md^Xm, Md^Xm, Md^Xm, Md^Xm, Md^Xm, Md^Xm, Md^Xm, Md^Xm, Md^Xm, Md^Xm, Md^Xm, Md^Xm, Md^Xm, Md^Xm, Md^Xm, Mm, Mm, Mm, Mm
Mm, Mm, Md^Xm, Mm, Mm, Mm, Mm, Mm, Mm, Mm, Mm, Mm, Mm, Mm, Mm, Mm, Gg, Hh, Mm, Hh, Gg, Mm, Gg, Mm, Mm, Mm, Mm, Md^Xm, Md^Xm, Md^Xm, Md^Xm, Md^Xm, Md^Xm, Md^Xm, Md^Xm, Md^Xm, Md^Xm, Md^Xm, Md^Xm, Md^Xm, Mm, Mm, Md^Xm, Md^Xm
Mm, Mm, Md^Xm, Mm, Mm, Mm, Mm, Mm, Mm, Mm, Md^Xm, Mm, Mm, Mm, Mm, Hh, Hh, Gg, Gg, Hh, Hh, Gg, Mm, Rp, Rp, Mm, Mm, Mm, Mm, Md^Xm, Mm, Mm, Mm, Md^Xm, Mm, Md^Xm, Md^Xm, Md^Xm, Md^Xm, Md^Xm, Mm, Md^Xm, Mm, Mm
Mm, Mm, Mm, Md^Xm, Mm, Mm, Md^Xm, Md^Xm, Mm, Md^Xm, Md^Xm, Md^Xm, Mm, Mm, Mm, Hh, Mm, Gg, Mm, Mm, Mm, Mm, Mm, Rp, Gg, Mm, Mm, Mm, Mm, Mm, Mm, Mm, Mm, Mm, Mm, Mm, Mm, Md^Xm, Mm, Md^Xm, Mm, Md^Xm, Mm, Mm
Mm, Mm, Mm, Md^Xm, Mm, Mm, Md^Xm, Mm, Mm, Mm, Md^Xm, Mm, Mm, Mm, Mm, Mm, Mm, Mm, Mm, Mm, Mm, Mm, Mm, Mm, Gg, Hh, Hh, Hh, Hh, Mm, Mm, Mm, Mm, Mm, Mm, Mm, Mm, Md^Xm, Md^Xm, Mm, Mm, Mm, Md^Xm, Mm
Mm, Mm, Mm, Md^Xm, Md^Xm, Mm, Md^Xm, Md^Xm, Md^Xm, Md^Xm, Mm, Md^Xm, Md^Xm, Mm, Md^Xm, Mm, Mm, Mm, Mm, Mm, Mm, Mm, Mm, Mm, Gg, Gg, Mm, Hh, Mm, Mm, Mm, Mm, Md^Xm, Mm, Mm, Mm, Mm, Md^Xm, Mm, Mm, Mm, Mm, Mm, Md^Xm
Mm, Mm, Mm, Mm, Mm, Md^Xm, Mm, Mm, Mm, Mm, Mm, Md^Xm, Mm, Md^Xm, Md^Xm, Md^Xm, Mm, Mm, Mm, Mm, Mm, Mm, Mm, Mm, Gg, Gg, Mm, Hh, Mm, Mm, Mm, Md^Xm, Md^Xm, Md^Xm, Mm, Mm, Mm, Md^Xm, Mm, Mm, Mm, Mm, Mm, Mm
Mm, Mm, Mm, Mm, Mm, Md^Xm, Mm, Mm, Mm, Mm, Mm, Mm, Mm, Mm, Mm, Md^Xm, Mm, Mm, Mm, Mm, Hh, Hh, Gg, Gg, Mm, Mm, Mm, Mm, Mm, Mm, Md^Xm, Md^Xm, Mm, Md^Xm, Mm, Md^Xm, Md^Xm, Md^Xm, Md^Xm, Mm, Mm, Mm, Mm, Mm
Mm, Mm, Mm, Mm, Md^Xm, Md^Xm, Mm, Mm, Md^Xm, Md^Xm, Mm, Md^Xm, Mm, Mm, Md^Xm, Md^Xm, Md^Xm, Mm, Mm, Hh, Hh, Hh, Hh, Hh, Mm, Mm, Mm, Mm, Mm, Md^Xm, Mm, Mm, Mm, Md^Xm, Mm, Mm, Md^Xm, Mm, Md^Xm, Mm, Md^Xm, Mm, Md^Xm, Mm
Mm, Mm, Mm, Mm, Md^Xm, Mm, Mm, Mm, Mm, Mm, Md^Xm, Mm, Mm, Md^Xm, Mm, Md^Xm, Md^Xm, Mm, Mm, Mm, Gg, Gg, Mm, Mm, Mm, Md^Xm, Md^Xm, Mm, Mm, Mm, Md^Xm, Mm, Md^Xm, Md^Xm, Mm, Mm, Mm, Md^Xm, Md^Xm, Mm, Mm, Md^Xm, Mm, Md^Xm
Mm, Mm, Mm, Mm, Md^Xm, Mm, Mm, Mm, Mm, Mm, Md^Xm, Mm, Mm, Mm, Mm, Md^Xm, Md^Xm, Mm, Mm, Mm, Mm, Gg, Gg, Mm, Mm, Md^Xm, Md^Xm, Md^Xm, Md^Xm, Mm, Mm, Mm, Mm, Mm, Mm, Mm, Mm, Md^Xm, Md^Xm, Mm, Mm, Md^Xm, Mm, Mm
Mm, Mm, Mm, Mm, Md^Xm, Mm, Mm, Md^Xm, Mm, Mm, Mm, Mm, Mm, Mm, Mm, Mm, Md^Xm, Mm, Mm, Mm, Mm, Mm, Gg, Mm, Mm, Mm, Mm, Mm, Mm, Md^Xm, Md^Xm, Mm, Mm, Mm, Mm, Mm, Mm, Mm, Md^Xm, Mm, Mm, Mm, Mm, Mm
Mm, Mm, Mm, Md^Xm, Mm, Mm, Md^Xm, Mm, Mm, Mm, Md^Xm, Mm, Mm, Md^Xm, Mm, Mm, Mm, Md^Xm, Mm, Mm, Mm, Mm, Mm, Gg, Gg, Mm, Md^Xm, Mm, Mm, Mm, Mm, Md^Xm, Md^Xm, Md^Xm, Mm, Mm, Md^Xm, Md^Xm, Mm, Mm, Mm, Mm, Mm, Md^Xm
Mm, Mm, Md^Xm, Md^Xm, Mm, Md^Xm, Mm, Mm, Md^Xm, Mm, Mm, Mm, Mm, Mm, Mm, Mm, Mm, Mm, Mm, Mm, Mm, Mm, Mm, Mm, Hh, Mm, Mm, Mm, Md^Xm, Mm, Mm, Mm, Mm, Md^Xm, Md^Xm, Md^Xm, Mm, Md^Xm, Mm, Mm, Mm, Mm, Mm, Md^Xm
Mm, Mm, Mm, Md^Xm, Md^Xm, Mm, Mm, Mm, Mm, Mm, Mm, Mm, Mm, Mm, Mm, Mm, Mm, Mm, Mm, Mm, Mm, Hh, Mm, Mm, Hh, Mm, Mm, Mm, Md^Xm, Md^Xm, Mm, Md^Xm, Mm, Md^Xm, Mm, Mm, Mm, Md^Xm, Md^Xm, Mm, Mm, Mm, Mm, Md^Xm
Mm, Mm, Mm, Mm, Md^Xm, Mm, Mm, Md^Xm, Mm, Mm, Mm, Mm, Mm, Mm, Mm, Mm, Hh, Hh, Hh, Mm, Gg, Hh, Hh, Mm, Gg, Mm, Mm, Mm, Mm, Md^Xm, Md^Xm, Mm, Mm, Mm, Mm, Mm, Mm, Md^Xm, Md^Xm, Mm, Mm, Md^Xm, Mm, Md^Xm
Mm, Mm, Mm, Mm, Md^Xm, Mm, Mm, Md^Xm, Mm, Mm, Mm, Mm, Hh, Mm, Gg, Hh, Mm, Gg, Gg, Gg, Gg, Hh, Gg, Gg, Mm, Mm, Mm, Mm, Md^Xm, Md^Xm, Md^Xm, Md^Xm, Md^Xm, Mm, Mm, Mm, Mm, Mm, Md^Xm, Mm, Mm, Mm, Mm, Mm
Mm, Mm, Md^Xm, Md^Xm, Mm, Mm, Mm, Md^Xm, Mm, Mm, Mm, Hh, Gg, Gg, Mm, Mm, Mm, Mm, Mm, Gg, Mm, Mm, Mm, Hh, Hh, Mm, Mm, Mm, Mm, Mm, Mm, Mm, Mm, Md^Xm, Mm, Mm, Mm, Md^Xm, Md^Xm, Mm, Md^Xm, Mm, Mm, Mm
Mm, Mm, Md^Xm, Mm, Mm, Mm, Md^Xm, Md^Xm, Md^Xm, Mm, Mm, Mm, Hh, Hh, Mm, Mm, Mm, Mm, Mm, Mm, Mm, Mm, Mm, Mm, Mm, Hh, Mm, Mm, Mm, Mm, Mm, Mm, Mm, Mm, Md^Xm, Md^Xm, Mm, Mm, Md^Xm, Mm, Mm, Md^Xm, Mm, Md^Xm
Mm, Md^Xm, Mm, Mm, Mm, Mm, Mm, Mm, Mm, Mm, Mm, Hh, Hh, Gg, Gg, Mm, Mm, Md^Xm, Md^Xm, Md^Xm, Md^Xm, Mm, Mm, Mm, Md^Xm, Mm, Mm, Mm, Md^Xm, Mm, Mm, Md^Xm, Mm, Mm, Mm, Mm, Mm, Mm, Md^Xm, Mm, Mm, Mm, Mm, Mm
Mm, Md^Xm, Mm, Md^Xm, Mm, Mm, Mm, Mm, Mm, Mm, Hh, Hh, Mm, Mm, Gg, Mm, Mm, Mm, Mm, Mm, Mm, Md^Xm, Mm, Md^Xm, Mm, Md^Xm, Md^Xm, Md^Xm, Md^Xm, Mm, Mm, Md^Xm, Mm, Mm, Md^Xm, Md^Xm, Md^Xm, Md^Xm, Md^Xm, Md^Xm, Mm, Mm, Mm, Mm
Mm, Md^Xm, Md^Xm, Mm, Mm, Mm, Md^Xm, Md^Xm, Mm, Mm, Hh, Hh, Mm, Mm, Gg, Gg, Gg, Mm, Mm, Mm, Mm, Mm, Mm, Mm, Mm, Md^Xm, Mm, Md^Xm, Mm, Md^Xm, Md^Xm, Md^Xm, Md^Xm, Md^Xm, Mm, Mm, Mm, Mm, Md^Xm, Mm, Mm, Mm, Mm, Mm
Mm, Mm, Md^Xm, Mm, Mm, Mm, Md^Xm, Mm, Mm, Mm, Mm, Mm, Mm, Mm, Mm, Gg, Gg, Mm, Mm, Mm, Mm, Mm, Md^Xm, Mm, Mm, Md^Xm, Mm, Mm, Mm, Mm, Mm, Mm, Md^Xm, Mm, Mm, Mm, Mm, Md^Xm, Md^Xm, Mm, Mm, Mm, Mm, Mm
Mm, Mm, Md^Xm, Mm, Mm, Mm, Mm, Mm, Mm, Mm, Mm, Mm, Mm, Mm, Mm, Gg, Hh, Gg, Mm, Mm, Mm, Mm, Mm, Md^Xm, Md^Xm, Md^Xm, Md^Xm, Mm, Mm, Mm, Mm, Md^Xm, Mm, Mm, Md^Xm, Mm, Md^Xm, Md^Xm, Md^Xm, Mm, Mm, Mm, Mm, Mm
Mm, Mm, Md^Xm, Mm, Mm, Mm, Md^Xm, Mm, Mm, Md^Xm, Mm, Mm, Mm, Mm, Mm, Gg, Hh, Gg, Gg, Gg, Mm, Mm, Mm, Mm, Mm, Md^Xm, Mm, Mm, Mm, Mm, Mm, Mm, Md^Xm, Mm, Md^Xm, Md^Xm, Mm, Mm, Md^Xm, Md^Xm, Md^Xm, Mm, Mm, Mm
Mm, Mm, Md^Xm, Mm, Mm, Mm, Md^Xm, Mm, Mm, Md^Xm, Md^Xm, Mm, Mm, Mm, Mm, Mm, Mm, Hh, Gg, Mm, Mm, Mm, Mm, Mm, Mm, Mm, Mm, Mm, Md^Xm, Md^Xm, Mm, Mm, Mm, Mm, Mm, Mm, Mm, Md^Xm, Md^Xm, Mm, Mm, Mm, Mm, Mm
Mm, Mm, Mm, Md^Xm, Md^Xm, Mm, Mm, Mm, Mm, Mm, Md^Xm, Md^Xm, Md^Xm, Mm, Mm, Mm, Mm, Mm, Mm, Gg, Gg, Mm, Mm, Mm, Hh, Mm, Mm, Mm, Mm, Mm, Md^Xm, Mm, Mm, Md^Xm, Mm, Mm, Mm, Mm, Md^Xm, Mm, Mm, Mm, Mm, Mm
Mm, Mm, Mm, Md^Xm, Md^Xm, Mm, Mm, Mm, Md^Xm, Md^Xm, Mm, Md^Xm, Md^Xm, Mm, Mm, Mm, Mm, Mm, Hh, Hh, Gg, Mm, Mm, Hh, Mm, Hh, Hh, Mm, Mm, Mm, Mm, Mm, Md^Xm, Mm, Mm, Mm, Mm, Md^Xm, Md^Xm, Mm, Mm, Md^Xm, Mm, Mm
Mm, Mm, Md^Xm, Md^Xm, Md^Xm, Md^Xm, Md^Xm, Md^Xm, Mm, Mm, Mm, Mm, Mm, Md^Xm, Md^Xm, Mm, Mm, Mm, Mm, Hh, Hh, Gg, Gg, Gg, Gg, Mm, Hh, Hh, Hh, Mm, Mm, Mm, Md^Xm, Mm, Mm, Mm, Mm, Mm, Md^Xm, Md^Xm, Mm, Mm, Mm, Mm
Mm, Md^Xm, Md^Xm, Mm, Mm, Mm, Mm, Mm, Mm, Mm, Mm, Mm, Mm, Md^Xm, Mm, Md^Xm, Md^Xm, Mm, Mm, Mm, Mm, Hh, Mm, Gg, Gg, Gg, Gg, Hh, Mm, Mm, Mm, Mm, Md^Xm, Mm, Mm, Md^Xm, Mm, Mm, Md^Xm, Mm, Mm, Mm, Mm, Mm
Md^Xm, Mm, Md^Xm, Mm, Mm, Mm, Md^Xm, Md^Xm, Md^Xm, Mm, Mm, Md^Xm, Mm, Mm, Mm, Mm, Mm, Md^Xm, Md^Xm, Mm, Mm, Mm, Mm, Mm, Mm, Mm, Mm, Gg, Mm, Mm, Mm, Mm, Md^Xm, Mm, Mm, Mm, Md^Xm, Mm, Md^Xm, Md^Xm, Mm, Mm, Mm, Mm
Mm, Md^Xm, Md^Xm, Mm, Mm, Mm, Mm, Md^Xm, Md^Xm, Md^Xm, Mm, Mm, Mm, Mm, Mm, Mm, Mm, Mm, Mm, Mm, Mm, Mm, Mm, Mm, Mm, Mm, Gg, Gg, Mm, Mm, Mm, Mm, Mm, Mm, Mm, Mm, Md^Xm, Md^Xm, Md^Xm, Mm, Mm, Mm, Mm, Mm
Mm, Md^Xm, Md^Xm, Mm, Md^Xm, Mm, Mm, Md^Xm, Mm, Md^Xm, Mm, Mm, Mm, Hh, Hh, Hh, Mm, Mm, Mm, Mm, Mm, Mm, Mm, Mm, Gg, Mm, Gg, Gg, Hh, Mm, Mm, Mm, Mm, Mm, Mm, Mm, Mm, Md^Xm, Mm, Mm, Mm, Mm, Mm, Mm
Mm, Md^Xm, Md^Xm, Mm, Mm, Mm, Md^Xm, Mm, Mm, Mm, Mm, Mm, Mm, Hh, Mm, Hh, Gg, Mm, Gg, Gg, Hh, Hh, Hh, Gg, Hh, Gg, Hh, Hh, Mm, Hh, Hh, Mm, Mm, Mm, Md^Xm, Mm, Mm, Md^Xm, Mm, Mm, Mm, Mm, Mm, Mm
Mm, Mm, Md^Xm, Mm, Mm, Mm, Mm, Md^Xm, Mm, Mm, Mm, Mm, Hh, Hh, Gg, Gg, Mm, Gg, Mm, Mm, Hh, Gg, Hh, Hh, Mm, Mm, Mm, Mm, Mm, Mm, Mm, Mm, Md^Xm, Mm, Mm, Mm, Mm, Md^Xm, Mm, Mm, Mm, Mm, Mm, Mm
Mm, Md^Xm, Mm, Mm, Mm, Mm, Mm, Md^Xm, Mm, Mm, Mm, Mm, Hh, Hh, Gg, Hh, Mm, Mm, Mm, Mm, Hh, Hh, Mm, Mm, Mm, Mm, Mm, Mm, Md^Xm, Md^Xm, Mm, Mm, Mm, Mm, Mm, Mm, Mm, Md^Xm, Md^Xm, Mm, Mm, Mm, Mm, Mm
Mm, Md^Xm, Mm, Md^Xm, Mm, Md^Xm, Mm, Md^Xm, Mm, Mm, Mm, Mm, Mm, Gg, Re, Mm, Mm, Mm, Mm, Mm, Mm, Hh, Mm, Mm, Mm, Mm, Md^Xm, Md^Xm, Mm, Mm, Mm, Mm, Mm, Mm, Mm, Mm, Mm, Mm, Md^Xm, Mm, Mm, Mm, Mm, Mm
Mm, Md^Xm, Mm, Mm, Mm, Mm, Mm, Md^Xm, Mm, Mm, Mm, Mm, Mm, Gg, Gg, Hh, Hh, Mm, Mm, Mm, Mm, Mm, Md^Xm, Mm, Md^Xm, Mm, Mm, Mm, Mm, Mm, Mm, Mm, Md^Xm, Mm, Md^Xm, Md^Xm, Md^Xm, Mm, Md^Xm, Mm, Mm, Mm, Mm, Mm
Mm, Md^Xm, Md^Xm, Md^Xm, Mm, Mm, Mm, Md^Xm, Md^Xm, Mm, Mm, Mm, Hh, Hh, Gg, Mm, Mm, Mm, Mm, Mm, Mm, Mm, Mm, Md^Xm, Mm, Md^Xm, Md^Xm, Md^Xm, Md^Xm, Md^Xm, Md^Xm, Md^Xm, Mm, Md^Xm, Md^Xm, Mm, Mm, Md^Xm, Mm, Mm, Mm, Mm, Mm, Mm
Mm, Mm, Mm, Mm, Md^Xm, Mm, Md^Xm, Mm, Mm, Mm, Mm, Mm, Mm, Hh, Mm, Gg, Gg, Hh, Mm, Mm, Hh, Mm, Mm, Md^Xm, Mm, Mm, Mm, Mm, Mm, Mm, Mm, Mm, Md^Xm, Mm, Mm, Mm, Md^Xm, Mm, Mm, Mm, Mm, Mm, Mm, Mm
Md^Xm, Mm, Mm, Mm, Mm, Mm, Mm, Mm, Md^Xm, Mm, Mm, Mm, Mm, Mm, Mm, Mm, Gg, Hh, Mm, Hh, Gg, Mm, Mm, Mm, Md^Xm, Mm, Md^Xm, Md^Xm, Mm, Mm, Md^Xm, Mm, Mm, Mm, Mm, Mm, Mm, Mm, Mm, Mm, Mm, Mm, Mm, Mm
Mm, Mm, Mm, Md^Xm, Mm, Mm, Mm, Mm, Mm, Mm, Md^Xm, Mm, Mm, Mm, Mm, Hh, Hh, Gg, Gg, Hh, Hh, Mm, Mm, Mm, Mm, Mm, Mm, Mm, Md^Xm, Mm, Mm, Md^Xm, Mm, Mm, Md^Xm, Md^Xm, Mm, Mm, Mm, Mm, Mm, Mm, Mm, Mm
Mm, Mm, Mm, Mm, Md^Xm, Mm, Mm, Mm, Mm, Mm, Mm, Md^Xm, Mm, Mm, Hh, Hh, Hh, Gg, Gg, Mm, Mm, Mm, Mm, Mm, Hh, Mm, Mm, Mm, Md^Xm, Mm, Mm, Mm, Mm, Mm, Mm, Mm, Mm, Mm, Mm, Mm, Mm, Mm, Gg, Gg
Mm, Mm, Mm, Mm, Mm, Mm, Mm, Md^Xm, Mm, Mm, Mm, Mm, Mm, Mm, Hh, Hh, Hh, Hh, Hh, Gg, Mm, Mm, Mm, Rp, Hh, Mm, Mm, Mm, Mm, Mm, Mm, Md^Xm, Mm, Mm, Mm, Mm, Mm, Mm, Mm, Mm, Gg, Gg, Gg, Gg
Md^Xm, Mm, Mm, Mm, Mm, Mm, Mm, Mm, Mm, Mm, Md^Xm, Mm, Mm, Mm, Mm, Mm, Mm, Hh, Mm, Mm, Mm, Mm, Mm, Rp, Mm, Mm, Mm, Mm, Mm, Mm, Mm, Mm, Mm, Mm, Mm, Mm, Gg, Mm, Gg, Gg, Gg, Gg, Gg, Gg
Mm, Mm, Mm, Mm, Mm, Mm, Mm, Mm, Mm, Mm, Mm, Mm, Mm, Mm, Mm, Mm, Mm, Mm, Mm, Mm, Mm, Mm, Mm, Rp, Hh, Mm, Mm, Mm, Mm, Mm, Mm, Mm, Mm, Mm, Gg, Gg, Gg, Gg, Gg, Gg, Gg, Gg, Gg, Gg
Mm, Mm, Mm, Mm, Mm, Mm, Mm, Mm, Mm, Mm, Mm, Mm, Mm, Mm, Mm, Mm, Gg, Gg, Gg, Mm, Mm, Mm, Hh, Gg, Gg, Hh, Hh, Hh, Gg, Mm, Mm, Mm, Gg, Gg, Gg, Gg, Gg, Gg, Gg, Gg, Gg, Gg, Gg, Gg
Mm, Mm, Ms^Xm, Mm, Mm, Mm, Gg, Gg, Gg, Mm, Gg, Gg, Gg, Mm, Gg, Gg, Gg, Gg, Gg, Gg, Hh, Hh, Hh, Gg, Gg, Hh, Gg, Hh, Hh, Gg, Gg, Gg, Gg, Gg, Gg, Gg, Gg, Gg, Gg, Gg, Gg, Gg, Gg, Gg
Mm, Md^Xm, Md^Xm, Mm, Gg, Gg, Gg, Gg, Gg, Gg, Gg, Gg, Gg, Gg, Gg, Gg, Gg, Gg, Gg, Gg, Gg, Gg, Gg, Gg, Gg, Gg, Gg, Gg, Gg, Gg, Gg, Gg, Gg, Gg, Gg, Gg, Gg, Gg, Gg, Gg, Gg, Gg, Gg, Gg
Gg, Gg, Gg, Gg, Gg, Gg, Gg, Gg, Gg, Gg, Gg, Gg, Gg, Gg, Gg, Gg, Gg, Gg, Gg, Gg, Gg, Gg, Gg, Gg, Gg, Gg, Gg, Gg, Gg, Gg, Gg, Gg, Gg, Gg, Gg, Gg, Gg, Gg, Gg, Gg, Gg, Gg, Gg, Gg
Gg, Gg, Gg, Gg, Gg, Gg, Gg, Gg, Gg, Gg, Gg, Gg, Gg, Gg, Gg, Gg, Gg, Gg, Gg, Gg, Gg, Gg, Gg, Gg, Gg, Gg, Gg, Gg, Gg, Gg, Gg, Gg, Gg, Gg, Gg, Gg, Gg, Gg, Gg, Gg, Gg, Gg, Gg, Gg
Gg, Gg, Gg, Gg, Gg, Gg, Gg, Gg, Gg, Gg, Gg, Gg, Gg, Gg, Gg, Gg, Gg, Gg, Gg, Gg, Gg, Gg, Gg, Gg, Gg, Gg, Gg, Gg, Gg, Gg, Gg, Gg, Gg, Gg, Gg, Gg, Gg, Gg, Gg, Gg, Gg, Gg, Gg, Gg
Gg, Gg, Gg, Gg, Gg, Gg, Gg, Gg, Gg, Gg, Gg, Gg, Gg, Gg, Gg, Gg, Gg, Gg, Gg, Gg, Gg, Gg, Gg, Gg, Gg, Gg, Gg, Gg, Gg, Gg, Gg, Gg, Gg, Gg, Gg, Gg, Gg, Gg, Gg, Gg, Gg, Gg, Gg, Gg
