Gg, Gg, Gs, Gg, Gs, Gg, Gg, Gg, Gg, Gg, Gg, Gg, Gs, Gg, Gs, Gg, Gs, Gg, Gs, Gg, Gg, Gg, Gg, Gg, Gg, Gg, Gg, Gg, Gg, Gg, Gg, Gg, Gg, Gg, Gg, Gg, Gg, Gg, Gg, Gg, Gg, Gg, Gg, Gg, Gg, Gg, Gg, Gg, Gs^Fms, Gs^Fms, Gs^Fms, Gg
Gs, Gs, Gg, Gs, Gg, Gg, Gg, Gg, Gg, Gg, Gs, Gs, Gg, Gg, Gg, Gg, Gs^Fms, Gs^Fms, Gg^Gvs, Gg, Gs^Gvs, Gg, Gs^Gvs, Gg, Gg, Gg, Gs^Fms, Gg, Gs, Gg, Gs^Vh, Gg, Gs^Vh, Gg, Gg, Gg, Ce, Gg, Ce, Ce, Ce, Gg, Gg, Gg, Gg, Gg, Gs^Fms, Gs^Fms, Gs, Gll^Fp, Gll^Fp, Gg
Gg, Gg, Gg, Gg, Gg, Gg, Ce, Gg, Gg, Gg, Gg, Gs, Gg, Gs^Vh, Gg, Gg, Gg^Efm, Gg^Gvs, Gg^Gvs, Gs^Fms, Gg^Gvs, Gs^Fms, Gg^Gvs, Gs, Gg, Gs^Fms, Gs^Vh, Gs^Fms, Gg, Gs, Gs, Gg, Gg, Gg, Gg, Gg, Ce, Ke, Ce, Ce, Ce, Gg, Gg, Gg, Gg, Gg, Gg, Gs, Gg, Gg^Efm, Gg, Gs^Fms
Gg, Gg, Gg, Ce, Ke, Ce, Gg, Gg, Gg, Gg, Gg, Gs, Gs, Gg, Gg, Gg^Eff, Gg^Eff, Gg^Efm, Gs^Efm, Gs^Vh, Gg^Gvs, Gg^Gvs, Gs, Gs^Fms, Gg, Gs^Fms, Gs^Fms, Gll^Fp, Gll^Fp, Gll^Fp, Gs^Fds, Gg, Gg, Gg, Gg, Gg, Gg, Ce, Gg, Ce, Gg, Gg, Gg, Gg, Gs, Gs^Fms, Gg, Gs, Gg, Gg^Wm, Gg, Gg
Gg, Gg, Gg, Ce, Gg, Gg, Gg, Gg, Gg, Gg, Gg, Gg, Gs, Gg, Gs, Gg, Gg, Gg^Eff, Gg^Eff, Gg^Gvs, Gg^Eff, Gs^Eff, Gg, Gg, Gg, Gg, Gg, Gs^Fms, Gs^Fds, Gll^Fp, Gs^Fms, Gll^Fp, Gll^Fp, Gg, Gs^Fms, Gg, Gll^Fp, Gg, Gg^Efm, Gg, Gg, Gs^Vh, Gg, Gs, Gg, Gs^Fms, Gs, Gs^Vh, Gg, Gg, Gg^Efm, Gg
Gg, Gg, Gg, Gg, Gg, Gg, Gg, Gg, Gg, Gg, Gg, Gg, Gs, Gs, Gg, Gs, Gg, Gs, Gs, Gg^Eff, Gg, Gg, Gg, Gg, Gg^Efm, Gg^Efm, Gs, Gs, Gs, Gs, Gg, Gs^Fms, Gs^Fms, Gll^Fp, Gs^Fds, Gs^Fms, Gs^Fms, Gll^Efm, Gll^Fp, Gg, Gs, Gg, Gs, Gs, Gs^Fms, Gs, Gs, Gs^Efm, Gg, Gg, Gg^Efm, Gg
Gg, Gg, Gg, Gg, Ce, Gg, Gg, Gg, Rp, Gg, Gg, Gg^Efm, Gs, Gg, Gg, Gg, Gg, Gs, Gg, Gg^Wm, Gg, Gg, Gg, Gg, Gg, Gs^Gvs, Gg^Gvs, Gg^Eff, Gg^Eff, Gs, Gs, Gg, Gs, Gg, Gg, Gg, Gg, Gs^Fms, Gg, Gll^Fp, Gll^Fp, Gll^Fp, Gs^Fms, Gll^Fp, Gll^Fp, Gll^Fp, Gg, Gs^Fms, Gll^Fp, Gg, Gg^Efm, Gg
Gg, Gg, Gg, Ce, Gg, Gg, Gg, Gg, Gg, Rp, Gs, Gs, Rp, Gs, Gg, Gs, Gg, Gs, Gs, Gg, Gg, Gg, Gg, Gg, Gs^Gvs, Gg^Gvs, Gg^Gvs, Gg^Gvs, Gs^Gvs, Gs^Eff, Gg^Eff, Gs^Vl, Gg, Gs, Gg, Gg, Gs, Gg, Gs, Gg, Gs, Gs^Fms, Gg, Gg, Gs, Gs^Fms, Gg, Gg, Gg, Gll^Fp, Gs^Fms, Gg
Gg, Gg, Gs, Ce, Ke, Ce, Gg, Gg, Gg, Gg, Gg, Gs, Gg, Gs, Rp, Gs, Rp, Gg, Gs, Gs, Gg, Gg, Gg, Gg, Gg, Gs^Vl, Gg^Gvs, Gs^Gvs, Gg^Eff, Gg^Eff, Gg^Gvs, Gg^Gvs, Gg^Gvs, Gg^Eff, Gg^Eff, Gg, Gs, Gg, Gg, Gg, Rp, Rp, Gg, Gg, Gg, Gg, Gg, Gs, Gs^Vh, Gs, Gg, Gg
Gs, Gg, Gg, Gg, Gg, Gg, Gg, Gg, Gg, Gs, Gg, Gs, Gg, Gg, Gg, Gg, Gs, Rp, Rp, Gs, Rp, Gg, Rp, Gs, Gg, Gg, Gg, Gs^Eff, Gg, Gg^Eff, Gg^Eff, Gg^Gvs, Gg^Eff, Gg^Eff, Gg, Gs, Gg, Gg, Gg, Gs, Gg, Gg, Gg, Gg, Gg, Gg, Gs, Gs, Gg, Gg, Gg, Gg
Gg, Gg, Gg, Gg, Gs, Gg, Gg, Gs, Gs^Efm, Gs, Gg, Gg, Gg, Gg, Gg, Gg, Gg, Gs, Gg, Gg, Gs, Rp, Gs, Rr, Rr, Gg, Gg, Gg, Gg, Gg, Gg, Gg^Eff, Gs, Gs, Gg, Gs, Gg, Gs, Rb, Gs, Gs, Rb, Gs, Rb, Gg, Rb, Gg, Gs, Gg, Gg, Gg, Gg
Gg, Gs^Fms, Gg, Gg, Gs, Gs, Gg, Gs^Efm, Gg, Gg, Gg, Gg, Gg, Gg, Gs^Fds, Gs, Gs, Gs, Gg, Gs, Gg, Gg, Gg, Gg, Rp, Rp, Gg, Gg, Gg, Gg, Gs, Gs, Re, Re, Gs, Re, Re, Re, Gd, Rb, Gd, Rb, Gd, Gd, Gd, Gg, Gg, Gs, Gd, Gg, Rp, Rp
Gg, Gs^Fms, Gs^Efm, Gg, Gg, Gg, Gs^Fds, Gs^Fds, Gg, Gs, Gg, Gg, Gg, Gg, Gg, Gg, Gs^Fds, Gs^Fds, Gg, Gg, Gg, Gg, Gs, Gg, Rp, Rp, Rp, Gg, Gg, Gg, Gs, Gs, Gg, Gg, Gd, Gd, Gd, Gd, Gs, Gd, Gs, Gs, Ce, Re, Rb, Gd, Gd, Gs, Gg, Gd, Gd, Gg
Gg, Gg^Efm, Gs^Fms, Gg, Gg, Gs^Fds, Gg, Gs^Fds, Gg, Gs^Fds, Gs^Fds, Gg, Gg, Gg, Gg, Gs^Fds, Gg, Gg, Gg, Gg, Gg, Gg, Gg, Gs, Gg, Rp, Rp, Gg, Gs, Gs, Gg, Gg, Gd, Gd, Gs, Gd, Gs, Gs, Gll, Ce, Rd, Rb, Rb, Ce, Re, Re, Gd, Gs, Gd, Gd, Rb, Gg
Gg, Gg, Gg^Efm, Gg, Gg, Gg, Gs, Gg, Gg, Gg, Gg, Gg, Gg, Gg, Gg, Gs^Fds, Gg, Gg, Gg, Gg, Gg, Gs, Gs, Gg, Gg, Gg, Gg, Rp, Rp, Gg, Gd, Rb, Re, Re, Re, Re, Gll, Gs, Rd, Gll, Re, Rd, Gll, Gd^Vo, Re, Rb, Ce, Gd, Rb, Gd, Gg, Gg
Gg, Gg, Gg, Gg, Gg, Gg, Gs^Fms, Gg, Gs^Fms, Gs^Fds, Gs^Fms, Gs^Fms, Gs^Fms, Gg, Gs^Fms, Gs^Fds, Gs^Fds, Gg, Gg, Gg, Gg, Gg, Gs, Gg, Gg, Gg, Gs, Gs, Gg, Gg, Rp, Gs, Re, Re, Gll, Gll, Rd, Rd, Rb, Re, Gll, Rd, Gll, Gll, Gll^Em, Gs, Gd, Ce, Ce, Re, Gg, Gg
Gg, Gg, Gg, Gg, Gs^Fms, Gs^Fms, Gg, Gg, Gg, Gg, Gs^Fms, Gs^Fms, Gg, Gs^Fms, Gg^Efm, Gs^Fms, Gg, Gs^Fds, Gg, Gs, Gg, Gg, Gs, Gg, Gg, Gg, Gs, Gs, Gd, Rp, Rp, Gs, Gs, Re, Rp, Rd, Rp, Rp, Rd, Gll, Ce, Gll^Em, Ce, Rd, Ce, Re, Gll, Gd, Gd, Gll, Rb, Gg
Gs^Fds, Gg, Gs^Fms, Gs, Gg, Gs^Fms, Gs^Fms, Gs^Fds, Gg, Gs^Fms, Gs^Fms, Gs, Gg, Gs, Gs^Efm, Gg, Gg, Gs^Fds, Gs, Gg, Gg, Gg, Gg, Gg, Gg, Gs, Gg, Gs, Gg, Gg, Gd, Re, Re, Rb, Rd, Rb, Ce, Gll, Gll^Em, Ce, Ke, Ce, Ce, Ce, Ce, Rd, Ce, Gs, Gs, Gd, Gll, Gg
Gs^Fds, Gs^Fds, Gs, Gs^Fds, Gg, Gg, Gs^Fms, Gg, Gs, Gs, Gs^Fms, Gg, Gg, Gg, Gg, Gs, Gs^Fms, Gs^Fds, Gg, Gg, Gg, Gg, Gs, Gg, Gg, Gs, Gg, Gd, Gg, Gg, Re, Gd, Gs, Gll, Gd^Vo, Rd, Ce, Rd, Gll, Ce, Ce, Re, Re, Re, Ce, Re, Ce, Gd, Gd^Vo, Gll, Re, Gg
Gg, Gs^Fds, Gg, Gg, Gs^Fds, Gg, Gs^Fds, Gs, Gg, Gs^Fds, Gg, Gs^Fms, Gs^Fds, Gg, Gg, Gs^Fms, Gs^Fms, Gs^Fms, Gs^Fms, Gg, Gs^Fms, Gg, Gg, Gs, Gg, Gg, Gg, Gg, Re, Gd, Gd, Re, Gll, Ce, Rb, Rd, Ce, Ce, Ce, Ce, Ce, Ce, Rd, Ce, Ce, Re, Rd, Rd, Rd, Re, Gs, Gg
Gg, Gg, Gs^Fds, Gs^Fds, Gs, Gs^Fms, Gg^Efm, Gg, Gs^Fds, Gs^Fds, Gg, Gg, Gs^Fds, Gg, Gs^Fds, Gs^Fds, Gg, Gg, Gs^Fms, Gg, Gs^Fms, Gg, Gs^Fms, Gg, Gs, Gs, Gg, Gd, Gg, Gg, Gd, Rb, Gll, Ce, Rb, Rd, Rd, Rd, Ce, Rd, Ce, Rd, Ce, Rd, Rd, Ce, Gll, Rd, Rb, Re, Rb, Gg
Gg, Gs, Gs^Fms, Gs^Fds, Gg, Gs^Efm, Gs^Fms, Gs^Fds, Gs^Fms, Gs^Fds, Gg, Gg, Gs^Fds, Gg, Gg, Gg, Gg, Gg, Gg, Gs^Fms, Gg, Gs^Fms, Gs^Fms, Gg, Gg, Gs, Gg, Re, Gd, Gg, Gg, Rb, Gll, Gs, Gd^Vo, Re^Em, Gd^Em, Rd, Rd, Ce, Ce, Ce, Ce, Ce, Rd, Rp, Rd, Rd, Gll, Rd, Gs, Gd
Gg, Gg, Gs^Fms, Gs^Fms, Gs^Fms, Gs^Efm, Gg, Gs^Fds, Gs^Fds, Gs^Fds, Gs^Fms, Gs^Fds, Gs^Fds, Gs^Fms, Gg, Gs^Fms, Gg, Gg, Gg, Gg, Gg^Efm, Gs^Fms, Gs^Fms, Gg, Gg, Gs, Gg, Re, Re, Gg, Gg, Gd, Gll, Gll, Re, Rb, Rb, Rd, Rd, Gd^Vo, Rd, Ket, Gll, Gll^Em, Rd, Rp, Rp, Gd^Vo, Re, Rb, Gs, Gg
Gg, Gg, Gg, Gs^Fms, Gg, Gs^Fms, Gg, Gg, Gg, Gg, Gs^Fds, Gs^Fds, Gs, Gs^Fds, Gs^Fds, Gs^Fds, Gg, Gs^Fms, Gs^Efm, Gg, Gg, Gs^Fms, Gs^Fms, Gs, Gs^Fms, Gg, Gs, Gg, Gg, Gd, Gg, Gd, Gd, Gll, Gll, Rb, Re, Rb, Ce, Re, Re, Gll, Re, Rd, Re, Gll, Rd, Rr, Rp, Gs, Rp, Gg
Gg, Gg^Efm, Gg, Gg, Gs^Fds, Gs^Fds, Gg, Gs^Fms, Gg, Gs^Fms, Gs^Fds, Gg, Gg, Gg, Gg, Gs, Gg, Gs^Fds, Gg, Gs^Efm, Gg^Efm, Gg, Gg, Gs^Fms, Gs, Gs^Fms, Gs^Fms, Gs, Gg, Gg, Gd, Gg, Gs, Gd, Gg, Gll, Gs, Gs, Re, Ce, Gs, Gll, Gll, Ce, Gs, Gll, Gd, Gs, Gs, Rp, Rp, Gd^Vo
Gg, Gg^Efm, Gg, Gg, Gg, Gs^Fds, Gs^Fds, Gs^Fds, Gg, Gs^Fds, Gs^Fms, Gs^Fds, Gs^Fms, Gg, Gs^Fms, Gg, Gs^Fms, Gg, Gg, Gg, Gs^Fds, Gs^Fds, Gs^Fds, Gs^Fds, Gg, Gs, Gs, Gs^Fms, Gg, Gg, Gs, Gd, Gs, Gs, Gg, Gs, Gs, Rd, Rd, Gll, Gll, Gs, Gll, Gs, Gd, Gd, Gd, Gg, Gd^Vo, Gs, Rp, Rr
Gg, Gg, Gg, Gg, Gg, Gg, Gg, Gg, Gg, Gg, Gg, Gg, Gg, Gg, Gg, Gg, Gg, Gg, Gg, Gg, Gg, Gg, Gg, Gg, Gg, Gg, Gg, Gs^Fms, Gg, Gs, Gg, Gg, Gg, Gg, Gd^Vo, Gg, Gg, Gg, Gg, Gg, Gg, Gll, Gg, Gll, Gg, Gg, Gg, Gg, Gg, Rr, Rr, Rp
