Ms^Xm, Ms^Xm, Ms, Ms, Ms, Ms, Ms, Ms, Ai, Ms, Ms, Ms, Ha, Ai, Wo, Ms, Ms, Ms, Ms, Ms, Ms^Xm, Ms, Ms, Ai
Ms, Ms, Ms, Ms, Ms, Ms, Wo, Ai, Ha, Wo, Wo, Wo, Wo, Wo, Ms, Ms, Ms, Ms, Ms^Xm, Ms^Xm, Ms^Xm, Ms, Ms, Ms
Ms, Ms, Ms, Ms, Ha, Wo, Ms, Ms^Xm, Ms^Xm, Wo, Wo, Wo, Ms, Ms, Ms, Ms, Ms, Ms, Ms^Xm, Ms, Ms, Ms, Ms, Ha
Ms, Ms, Ha, Ha, Ai, Ai, Aa^Fma, Ms, Ms, Ms^Xm, Ms, Ms, Ms, Ms, Ms^Xm, Ms^Xm, Ms^Xm, Ms^Xm, Ms, Ms, Ms, Ms, Ai, Ai^Es
Ms, Ms, Wo, Ai, Aa, Rb, Rb^Es, Aa^Fma, Aa^Fma, Ms, Ms, Ms, Ms^Xm, Ms, Ms^Xm, Ms^Xm, Ms^Xm, Ms^Xm, Ms, Ms, Ms, Ai, Wwr^Es, Ww^Es
Ms, Ms, Wo, Ai, Ms, Ha, Aa, Aa, Aa^Fma, Aa^Fma, Ms, Ms, Ms, Ms^Xm, Ms, Ms^Xm, Ms^Xm, Ms, Ms, Ms, Ai, Ai, Ha^Es, Wwt^Es
Ai, Wo, Wo, Ai, Ms, Ms, Aa, Rb^Es, Ha, Ha, Ms, Ms, Ms, Ms, Ms, Ms, Ms^Xm, Ms, Ms, Ms, Aa, Ha^Vhha, Ms, Ha^Es
Ms, Wo, Ms, Ms, Ha, Ms, Aa, Rb, Ha, Ha, Ms, Ms, Ms, Ms, Ms, Ms, Ms, Ms^Xm, Aa, Aa, Aa^Fma, Aa, Ms, Ms
Ms, Ms, Ms, Ms, Ms, Ha^Vhha, Ms, Aa, Aa, Aa^Fma, Aa^Fma, Ms, Ha, Ms, Ms, Ms, Ms, Ms^Xm, Ms, Aa, Ms^Xm, Ms, Ms^Xm, Ms^Xm
Ms, Ms, Ms, Ms, Ms, Ms, Ha, Ha, Aa, Rb, Aa, Aa, Ha, Ha^Es, Ms, Ms, Ms, Ms^Xm, Ms, Ms, Ms^Xm, Ms^Xm, Ms, Ms
Ms, Ms, Ms, Ms, Ms, Ms, Ha, Ms, Aa, Rb, Rb^Es, Rb^Eb, Ha^Vhha, Ha, Ha, Ms, Ms, Ms, Ms, Ms^Xm, Ms^Xm, Ms^Xm, Ms^Xm, Ms^Xm
Ms^Xm, Ms, Ms, Ms, Ms, Ms, Ms, Ha, Ha, Rb, Rb^Es, Ha, Ms, Ms, Ms, Ha, Ms, Ms, Ms, Ms^Xm, Ms^Xm, Ms, Ms, Ms^Xm
Ms^Xm, Ms^Xm, Ms, Ms, Ms, Ms, Ms, Ha, Ms, Aa, Rb, Aa, Aa, Ms, Ha, Ha, Ms, Ms, Ms^Xm, Ms^Xm, Ms, Ms, Ms^Xm, Ms^Xm
Ms, Ms, Ms, Ms, Ms, Ms, Ms, Ms^Xm, Ms, Aa^Fma, Aa, Rb, Aa, Ms, Ha, Ms, Ms^Xm, Ms, Ms^Xm, Ms^Xm, Ms^Xm, Ms^Xm, Ms, Ms^Xm
Ms, Ms, Ms, Ms, Ms, Ms, Ms, Ms, Ms, Ms, Aa^Fma, Rb, Ha, Ha, Ms^Xm, Ms, Ms, Ms, Ms, Ms^Xm, Ms^Xm, Ms^Xm, Ms, Ms^Xm
Ms^Xm, Ms, Ms, Ms, Ms, Ms, Ms, Ms^Xm, Ms, Ms, Aa^Fma, Rb, Ms, Ms, Ms, Ms, Ms, Ms, Ms^Xm, Ms, Ms, Ms^Xm, Ms^Xm, Ms
Ms, Ms^Xm, Ms, Ms, Ms, Ms, Ms, Ms, Ms, Ms, Ha, Aa, Aa, Aa, Ms, Ms, Aa^Fma, Ms, Ms, Ms, Ms, Ms, Ms, Ms^Xm
Ms^Xm, Ms^Xm, Ms, Ms, Ms, Ms, Ms, Ms, Ms, Ms, Ha, Ms, Rb, Ms, Aa, Aa, Ha, Aa^Fma, Aa, Ms, Ms, Ms, Ms, Ms
Ms^Xm, Ms^Xm, Ms, Ms, Ms, Ms, Ms, Ms, Ha, Ha, Aa, Ms, Ha^Vhha, Rb, Ha, Ha, Ha^Vhha, Ha, Rb, Ha, Aa, Ms, Ms, Ms
Ms^Xm, Ms^Xm, Ms, Ms, Ms, Ms, Ms, Ha, Ha, Ha, Aa, Ha, Ha, Rb, Kha, Ha, Ha, Ha, Rb, Aa, Rb, Aa, Ha, Ms
Ms^Xm, Ms, Ms, Ms, Ms^Xm, Ms, Ms, Ms, Ha, Aa^Fma, Aa, Ha, Cha, Rb, Rrc^Vhca, Rrc, Ha, Cha, Ha, Rb, Aa, Rb, Ms, Ms
Ms^Xm, Ms^Xm, Ms^Xm, Ms, Ms^Xm, Ms, Ms, Ms, Ha, Aa^Fma, Ha, Aa, Cha, Rrc, Rrc, Cha, Cha, Cha, Ha, Ms, Ms, Ms, Ms, Ms
Ms^Xm, Ms, Ms^Xm, Ms^Xm, Ms, Ms, Ms, Ms, Ms, Ms, Ms, Ha, Rb, Cha, Rrc, Kha, Aa, Cha, Aa, Ha^Vhha, Ms, Ms, Aa^Fma, Ms
Ms^Xm, Ms^Xm, Ms^Xm, Ms, Ms, Ms, Ms, Ms, Ms, Ha, Ha, Ha^Vhha, Rb, Cha, Cha, Rrc, Cha, Cha, Cha, Aa, Ha, Aa, Ms, Ms
Ms^Xm, Ms^Xm, Ms, Ms^Xm, Ms, Ms^Xm, Ms, Ha, Ha, Aa, Rb, Ha, Rb, Ha, Ha, Cha, Ha, Ha, Ha, Ha, Ha, Ms, Ms, Ms
Ms^Xm, Ms^Xm, Ms^Xm, Ms, Ms, Ms, Ms, Ha, Ha, Rb, Rb, Aa, Ha, Ms, Ha, Cha, Ha, Ha^Vhha, Ha, Ha, Rb, Aa, Aa^Fma, Ms
Ms^Xm, Ms^Xm, Ms^Xm, Ms^Xm, Ms^Xm, Ms, Ms, Ha, Ha, Ha, Rb, Aa^Fma, Ha, Ms, Ms, Rb, Rb, Rb, Aa, Ha, Aa, Aa, Aa^Fma, Ms
Ms, Ms^Xm, Ms^Xm, Ms, Ms, Ms, Aa, Ha, Aa^Fma, Ha, Ms, Ha, Aa^Fma, Ms, Ms, Aa, Ha, Aa, Ms, Ms, Ha, Rb, Ha, Ms
Ms, Ms, Ms, Ha, Aa, Ha, Rb, Aa^Fma, Ha, Ms, Ms, Ms, Ms, Ha, Ms, Ha, Ms, Ms, Ms, Ms, Ms, Ha, Ms, Ms
Ms, Ms, Ms, Ha, Ms, Rb, Ha, Ha, Ms, Ms, Ms, Ms, Ms, Ms, Ms, Ms, Ms, Ms, Ms, Ms, Ms, Ms, Ms, Ms
