Md^Xm, Md^Xm, Md^Xm, Mm, Mm, Mm, Hh, Hh, Mm, Mm, Mm, Mm, Mm, Mm, Mm, Mm, Mm, Mm, Mm, Hh, Mm, Mm, Mm, Mm, Mm, Mm, Mm, Mm, Md^Xm, Md^Xm, Mm, Mm, Md^Xm, Mm, Mm, Md^Xm, Mm, Md^Xm, Mm, Mm, Mm, Mm, Mm, Mm, Mm, Mm, Mm, Mm, Mm, Mm, Mm, Mm, Mm, Mm, Mm, Mm, Mm, Mm, Mm, Mm, Mm, Mm, Mm, Mm
Mm, Mm, Mm, Mm, Mm, Hh, Hh, Gg, Gg, Mm, Mm, Md^Xm, Md^Xm, Md^Xm, Md^Xm, Mm, Mm, Mm, Md^Xm, Mm, Mm, Mm, Md^Xm, Mm, Mm, Md^Xm, Mm, Mm, Mm, Mm, Mm, Mm, Md^Xm, Mm, Mm, Mm, Mm, Mm, Mm, Mm, Mm, Mm, Mm, Mm, Mm, Mm, Mm, Mm, Mm, Mm, Mm, Mm, Mm, Mm, Mm, Mm, Mm, Mm, Mm, Mm, Mm, Mm, Mm, Mm
Mm, Mm, Mm, Mm, Hh, Hh, Mm, Mm, Gg, Mm, Mm, Mm, Mm, Mm, Mm, Md^Xm, Mm, Md^Xm, Mm, Md^Xm, Md^Xm, Md^Xm, Md^Xm, Mm, Mm, Md^Xm, Mm, Mm, Md^Xm, Md^Xm, Md^Xm, Md^Xm, Md^Xm, Md^Xm, Mm, Mm, Mm, Mm, Mm, Mm, Mm, Mm, Mm, Mm, Mm, Mm, Mm, Mm, Ms^Xm, Mm, Mm, Mm, Mm, Mm, Mm, Mm, Mm, Mm, Mm, Mm, Mm, Mm, Mm, Mm
Md^Xm, Md^Xm, Mm, Mm, Hh, Hh, Mm, Mm, Gg, Gg, Gg, Mm, Mm, Mm, Mm, Mm, Mm, Mm, Mm, Md^Xm, Mm, Md^Xm, Mm, Md^Xm, Md^Xm, Md^Xm, Md^Xm, Md^Xm, Mm, Mm, Mm, Mm, Md^Xm, Mm, Mm, Mm, Mm, Mm, Mm, Mm, Ms^Xm, Mm, Ms^Xm, Ms^Xm, Ms^Xm, Ms^Xm, Ms^Xm, Ms^Xm, Ms^Xm, Ms^Xm, Ms^Xm, Mm, Ms^Xm, Mm, Mm, Mm, Mm, Mm, Mm, Mm, Mm, Mm, Mm, Mm
Md^Xm, Mm, Mm, Mm, Mm, Mm, Mm, Mm, Mm, Gg, Gg, Mm, Mm, Mm, Mm, Mm, Md^Xm, Mm, Mm, Md^Xm, Mm, Mm, Mm, Mm, Mm, Mm, Md^Xm, Mm, Mm, Mm, Mm, Md^Xm, Md^Xm, Mm, Mm, Mm, Mm, Mm, Mm, Mm, Md^Xm, Ms^Xm, Md^Xm, Ms, Ms, Ms, Ms, Ms, Ms, Ms^Xm, Ms^Xm, Ms^Xm, Ms^Xm, Ms^Xm, Ms^Xm, Mm, Mm, Mm, Mm, Mm, Mm, Mm, Mm, Mm
Mm, Mm, Mm, Mm, Mm, Mm, Mm, Mm, Mm, Gg, Hh, Gg, Mm, Mm, Mm, Mm, Mm, Md^Xm, Md^Xm, Md^Xm, Md^Xm, Mm, Mm, Mm, Mm, Md^Xm, Mm, Mm, Md^Xm, Mm, Md^Xm, Md^Xm, Md^Xm, Mm, Mm, Mm, Mm, Mm, Mm, Mm, Md^Xm, Md^Xm, Md^Xm, Ms, Ha, Ha, Ms, Ms, Ms, Ms, Ms, Ms, Md^Xm, Mm, Md^Xm, Mm, Mm, Mm, Mm, Mm, Mm, Mm, Mm, Mm
Md^Xm, Mm, Mm, Md^Xm, Mm, Mm, Mm, Mm, Mm, Gg, Hh, Gg, Gg, Gg, Mm, Mm, Mm, Mm, Mm, Md^Xm, Mm, Mm, Mm, Mm, Mm, Mm, Md^Xm, Mm, Md^Xm, Md^Xm, Mm, Mm, Md^Xm, Md^Xm, Md^Xm, Mm, Mm, Mm, Mm, Mm, Md^Xm, Md^Xm, Ms, Ms, Ha, Ms, Ms, Ms, Ms, Md^Xm, Ms, Ms, Ms, Md^Xm, Ms, Md^Xm, Md^Xm, Mm, Mm, Mm, Mm, Mm, Mm, Mm
Md^Xm, Mm, Mm, Md^Xm, Md^Xm, Mm, Mm, Mm, Mm, Mm, Mm, Hh, Gg, Mm, Mm, Mm, Mm, Mm, Mm, Mm, Mm, Mm, Md^Xm, Md^Xm, Mm, Mm, Mm, Mm, Mm, Mm, Mm, Md^Xm, Md^Xm, Mm, Mm, Mm, Mm, Mm, Mm, Mm, Md^Xm, Md^Xm, Ms, Ms, Ha, Ms, Ms, Ms, Ms, Md^Xm, Md^Xm, Ms, Md^Xm, Ms, Md^Xm, Ms, Md^Xm, Md^Xm, Mm, Mm, Mm, Mm, Mm, Mm
Mm, Mm, Mm, Mm, Md^Xm, Md^Xm, Md^Xm, Mm, Mm, Mm, Mm, Mm, Mm, Gg, Gg, Mm, Mm, Mm, Hh, Mm, Mm, Mm, Mm, Mm, Md^Xm, Mm, Mm, Md^Xm, Mm, Mm, Mm, Mm, Md^Xm, Mm, Mm, Mm, Mm, Mm, Mm, Mm, Md^Xm, Mm, Ms, Ms, Ms, Ms, Ms, Ms, Ms, Md^Xm, Ha, Ms, Ms, Md^Xm, Ms, Md^Xm, Mm, Mm, Mm, Mm, Md^Xm, Mm, Mm, Mm
Mm, Mm, Md^Xm, Md^Xm, Mm, Md^Xm, Md^Xm, Mm, Mm, Mm, Mm, Mm, Hh, Hh, Gg, Mm, Mm, Hh, Mm, Hh, Hh, Mm, Mm, Mm, Mm, Mm, Md^Xm, Mm, Mm, Mm, Mm, Md^Xm, Md^Xm, Mm, Mm, Md^Xm, Mm, Mm, Mm, Mm, Ms, Ms, Ms, Ms, Ha, Ha, Mm, Mm, Mm, Ms, Ms, Ha, Ha, Ms, Ha, Ms, Ms, Ms, Mm, Mm, Md^Xm, Mm, Mm, Mm
Md^Xm, Md^Xm, Mm, Mm, Mm, Mm, Mm, Md^Xm, Md^Xm, Mm, Mm, Mm, Mm, Hh, Hh, Gg, Gg, Gg, Gg, Mm, Hh, Hh, Hh, Mm, Mm, Mm, Md^Xm, Mm, Mm, Mm, Mm, Mm, Md^Xm, Md^Xm, Mm, Mm, Mm, Mm, Mm, Md^Xm, Ms, Ms, Ms, Ha, Mm, Mm, Mm, Ha, Ha, Mm, Ha, Ms, Ha, Ms, Ms, Ms, Md^Xm, Mm, Mm, Mm, Md^Xm, Md^Xm, Mm, Mm
Mm, Mm, Mm, Mm, Mm, Mm, Mm, Md^Xm, Mm, Md^Xm, Md^Xm, Mm, Mm, Mm, Mm, Hh, Mm, Gg, Gg, Gg, Gg, Hh, Mm, Mm, Mm, Mm, Md^Xm, Mm, Mm, Md^Xm, Mm, Mm, Md^Xm, Mm, Mm, Mm, Mm, Mm, Mm, Ms, Ms, Ms, Mm, Mm, Mm, Mm, Cte, Mm, Mm, Ha, Ha, Ha, Ms, Ms, Mm, Md^Xm, Md^Xm, Md^Xm, Mm, Mm, Md^Xm, Mm, Mm, Mm
Md^Xm, Md^Xm, Md^Xm, Mm, Mm, Md^Xm, Mm, Mm, Mm, Mm, Mm, Md^Xm, Md^Xm, Mm, Mm, Mm, Mm, Mm, Mm, Mm, Mm, Gg, Mm, Mm, Mm, Mm, Md^Xm, Mm, Mm, Mm, Md^Xm, Mm, Md^Xm, Md^Xm, Mm, Mm, Mm, Mm, Mm, Ms, Ms, Ms, Mm, Mm, Cte, Cte, Cte, Cte, Ha, Ha, Ha, Ms, Mm, Ms, Ms, Md^Xm, Md^Xm, Md^Xm, Md^Xm, Md^Xm, Md^Xm, Mm, Mm, Mm
Mm, Md^Xm, Md^Xm, Md^Xm, Mm, Mm, Mm, Mm, Mm, Mm, Mm, Mm, Mm, Mm, Mm, Mm, Mm, Mm, Mm, Mm, Gg, Gg, Mm, Mm, Mm, Mm, Mm, Mm, Mm, Mm, Md^Xm, Md^Xm, Md^Xm, Mm, Mm, Mm, Mm, Mm, Mm, Md^Xm, Mm, Mm, Mm, Mm, Cte, Cte, Kte, Ha, Cte, Ha, Mm, Ms, Ms, Ms, Mm, Md^Xm, Md^Xm, Md^Xm, Md^Xm, Mm, Mm, Mm, Mm, Mm
Mm, Md^Xm, Mm, Md^Xm, Mm, Mm, Mm, Hh, Hh, Hh, Mm, Mm, Mm, Mm, Mm, Mm, Mm, Mm, Gg, Mm, Gg, Gg, Hh, Mm, Mm, Mm, Mm, Mm, Mm, Mm, Mm, Md^Xm, Mm, Mm, Mm, Mm, Mm, Mm, Mm, Mm, Mm, Mm, Mm, Mm, Cte, Cte, Cte, Cte, Cte, Ha, Mm, Ms, Mm, Ms, Mm, Md^Xm, Mm, Md^Xm, Md^Xm, Mm, Mm, Mm, Mm, Mm
Md^Xm, Mm, Mm, Mm, Mm, Mm, Mm, Hh, Mm, Hh, Gg, Mm, Gg, Gg, Hh, Hh, Hh, Gg, Hh, Gg, Hh, Hh, Mm, Hh, Hh, Mm, Mm, Mm, Md^Xm, Mm, Mm, Md^Xm, Mm, Mm, Mm, Mm, Mm, Mm, Mm, Mm, Mm, Mm, Mm, Mm, Mm, Cte, Cte, Cte, Mm, Mm, Mm, Mm, Mm, Mm, Mm, Mm, Md^Xm, Md^Xm, Mm, Mm, Mm, Mm, Mm, Mm
Mm, Md^Xm, Mm, Mm, Mm, Mm, Hh, Hh, Gg, Gg, Mm, Gg, Mm, Mm, Hh, Gg, Hh, Hh, Mm, Mm, Mm, Mm, Mm, Mm, Mm, Mm, Md^Xm, Mm, Mm, Mm, Mm, Md^Xm, Mm, Mm, Mm, Mm, Mm, Mm, Mm, Mm, Mm, Mm, Mm, Mm, Mm, Mm, Mm, Mm, Mm, Mm, Mm, Mm, Mm, Mm, Md^Xm, Md^Xm, Mm, Mm, Mm, Mm, Mm, Mm, Mm, Mm
Mm, Md^Xm, Mm, Mm, Mm, Mm, Hh, Hh, Gg, Hh, Mm, Mm, Mm, Mm, Hh, Hh, Mm, Mm, Mm, Mm, Mm, Mm, Md^Xm, Md^Xm, Mm, Mm, Mm, Mm, Mm, Mm, Mm, Md^Xm, Md^Xm, Mm, Mm, Mm, Mm, Mm, Mm, Mm, Mm, Mm, Mm, Mm, Mm, Mm, Mm, Mm, Mm, Mm, Mm, Mm, Mm, Mm, Mm, Mm, Mm, Mm, Mm, Mm, Mm, Mm, Mm, Mm
Mm, Md^Xm, Mm, Mm, Mm, Mm, Mm, Gg, Re, Mm, Mm, Mm, Mm, Mm, Mm, Hh, Mm, Mm, Mm, Mm, Md^Xm, Md^Xm, Mm, Mm, Mm, Mm, Mm, Mm, Mm, Mm, Mm, Mm, Md^Xm, Mm, Mm, Mm, Mm, Mm, Mm, Mm, Mm, Mm, Mm, Mm, Mm, Mm, Mm, Mm, Mm, Mm, Mm, Mm, Mm, Mm, Mm, Mm, Mm, Mm, Mm, Mm, Mm, Mm, Gg, Gg
Mm, Md^Xm, Mm, Mm, Mm, Mm, Mm, Gg, Gg, Hh, Hh, Mm, Mm, Mm, Mm, Mm, Md^Xm, Mm, Md^Xm, Mm, Mm, Mm, Mm, Mm, Mm, Mm, Md^Xm, Mm, Md^Xm, Md^Xm, Md^Xm, Mm, Md^Xm, Mm, Mm, Mm, Mm, Mm, Mm, Mm, Mm, Mm, Mm, Mm, Mm, Mm, Mm, Mm, Mm, Mm, Mm, Mm, Mm, Mm, Mm, Mm, Mm, Mm, Mm, Mm, Gg, Gg, Gg, Gg
Mm, Md^Xm, Md^Xm, Mm, Mm, Mm, Hh, Hh, Gg, Mm, Mm, Mm, Mm, Mm, Mm, Mm, Mm, Md^Xm, Mm, Md^Xm, Md^Xm, Md^Xm, Md^Xm, Md^Xm, Md^Xm, Md^Xm, Mm, Md^Xm, Md^Xm, Mm, Mm, Md^Xm, Mm, Mm, Mm, Mm, Mm, Mm, Mm, Mm, Mm, Mm, Mm, Mm, Mm, Mm, Mm, Mm, Mm, Mm, Gg, Mm, Mm, Mm, Gg, Mm, Gg, Gg, Gg, Gg, Gg, Gg, Gg, Gg
Md^Xm, Mm, Mm, Mm, Mm, Mm, Mm, Hh, Mm, Gg, Gg, Hh, Mm, Mm, Hh, Mm, Mm, Md^Xm, Mm, Mm, Mm, Mm, Mm, Mm, Mm, Mm, Md^Xm, Mm, Mm, Mm, Md^Xm, Mm, Mm, Mm, Mm, Mm, Mm, Mm, Mm, Mm, Mm, Mm, Mm, Mm, Mm, Mm, Mm, Mm, Gg, Gg, Gg, Gg, Gg, Gg, Gg, Gg, Gg, Gg, Gg, Gg, Gg, Gg, Gg, Gg
Mm, Mm, Md^Xm, Mm, Mm, Mm, Mm, Mm, Mm, Mm, Gg, Hh, Mm, Hh, Gg, Mm, Mm, Mm, Md^Xm, Mm, Md^Xm, Md^Xm, Mm, Mm, Md^Xm, Mm, Mm, Mm, Mm, Mm, Mm, Mm, Mm, Mm, Mm, Mm, Mm, Mm, Mm, Mm, Mm, Mm, Mm, Mm, Mm, Mm, Gg, Gg, Gg, Gg, Gg, Gg, Gg, Gg, Gg, Gg, Gg, Gg, Gg, Gg, Gg, Gg, Gg, Gg
Mm, Mm, Mm, Mm, Md^Xm, Mm, Mm, Mm, Mm, Hh, Hh, Gg, Gg, Hh, Hh, Mm, Mm, Mm, Mm, Mm, Mm, Mm, Md^Xm, Mm, Mm, Md^Xm, Mm, Mm, Md^Xm, Md^Xm, Mm, Mm, Mm, Mm, Mm, Mm, Mm, Mm, Mm, Mm, Gg, Gg, Gg, Gg, Gg, Gg, Gg, Gg, Gg, Gg, Gg, Gg, Gg, Gg, Gg, Gg, Gg, Gg, Gg, Gg, Gg, Gg, Gg, Gg
Mm, Mm, Mm, Mm, Mm, Md^Xm, Mm, Mm, Hh, Hh, Hh, Gg, Gg, Mm, Mm, Mm, Mm, Mm, Hh, Mm, Mm, Mm, Md^Xm, Mm, Mm, Mm, Mm, Mm, Mm, Mm, Mm, Mm, Mm, Mm, Mm, Mm, Gg, Gg, Gg, Gg, Gg, Gg, Gg, Gg, Gg, Gg, Gg, Gg, Gg, Gg, Gg, Gg, Gg, Gg, Gg, Gg, Gg, Gg, Gg, Gg, Gg, Gg, Gg, Gg
Mm, Md^Xm, Mm, Mm, Mm, Mm, Mm, Mm, Hh, Hh, Hh, Hh, Hh, Gg, Mm, Mm, Mm, Rp, Hh, Mm, Mm, Mm, Mm, Mm, Mm, Md^Xm, Mm, Mm, Mm, Mm, Mm, Mm, Mm, Mm, Gg, Gg, Gg, Gg, Gg, Gg, Gg, Gg, Gg, Gg, Gg, Gg, Gg, Gg, Gg, Gg, Gg, Gg, Gg, Gg, Gg, Gg, Gg, Gg, Gg, Gg, Gg, Gg, Gg, Gg
Mm, Mm, Mm, Mm, Md^Xm, Mm, Mm, Mm, Mm, Mm, Mm, Hh, Mm, Mm, Mm, Mm, Mm, Rp, Mm, Mm, Mm, Mm, Mm, Mm, Mm, Mm, Mm, Mm, Mm, Mm, Gg, Mm, Gg, Gg, Gg, Gg, Gg, Gg, Gg, Gg, Gg, Gg, Gg, Gg, Gg, Gg, Gg, Gg, Gg, Gg, Gg, Gg, Gg, Gg, Gg, Gg, Gg, Gg, Gg, Gg, Gg, Gg, Gg, Gg
Mm, Mm, Mm, Mm, Mm, Mm, Mm, Mm, Mm, Mm, Mm, Mm, Mm, Mm, Mm, Mm, Mm, Rp, Hh, Mm, Mm, Mm, Mm, Mm, Mm, Mm, Mm, Mm, Gg, Gg, Gg, Gg, Gg, Gg, Gg, Gg, Gg, Gg, Gg, Gg, Gg, Gg, Gg, Gg, Gg, Gg, Gg, Gg, Gg, Gg, Gg, Gg, Gg, Gg, Gg, Gg, Gg, Gg, Gg, Gg, Gg, Gg, Gg, Gg
Mm, Mm, Mm, Mm, Mm, Mm, Mm, Mm, Mm, Mm, Gg, Gg, Gg, Mm, Mm, Mm, Hh, Gg, Gg, Hh, Hh, Hh, Gg, Mm, Mm, Mm, Gg, Gg, Gg, Gg, Gg, Gg, Gg, Gg, Gg, Gg, Gg, Gg, Gg, Gg, Gg, Gg, Gg, Gg, Gg, Gg, Gg, Gg, Gg, Gg, Gg, Gg, Gg, Gg, Gg, Gg, Gg, Gg, Gg, Gg, Gg, Gg, Gg, Gg
Gg, Gg, Gg, Mm, Gg, Gg, Gg, Mm, Gg, Gg, Gg, Gg, Gg, Gg, Hh, Hh, Hh, Gg, Gg, Hh, Gg, Hh, Hh, Gg, Gg, Gg, Gg, Gg, Gg, Gg, Gg, Gg, Gg, Gg, Gg, Gg, Gg, Gg, Gg, Gg, Gg, Gg, Gg, Gg, Gg, Gg, Gg, Gg, Gg, Gg, Gg, Gg, Gg, Gg, Gg, Gg, Gg, Gg, Gg, Gg, Gg, Gg, Gg, Gg
Gg, Gg, Gg, Gg, Gg, Gg, Gg, Gg, Gg, Gg, Gg, Gg, Gg, Gg, Gg, Gg, Gg, Gg, Gg, Gg, Gg, Gg, Gg, Gg, Gg, Gg, Gg, Gg, Gg, Gg, Gg, Gg, Gg, Gg, Gg, Gg, Gg, Gg, Gg, Gg, Gg, Gg, Gg, Gg, Gg, Gg, Gg, Gg, Gg, Gg, Gg, Gg, Gg, Gg, Gg, Gg, Gg, Gg, Gg, Gg, Gg, Gg, Gg, Gg
Gg, Gg, Gg, Gg, Gg, Gg, Gg, Gg, Gg, Gg, Gg, Gg, Gg, Gg, Gg, Gg, Gg, Gg, Gg, Gg, Gg, Gg, Gg, Gg, Gg, Gg, Gg, Gg, Gg, Gg, Gg, Gg, Gg, Gg, Gg, Gg, Gg, Gg, Gg, Gg, Gg, Gg, Gg, Gg, Gg, Gg, Gg, Gg, Gg, Gg, Gg, Gg, Gg, Gg, Gg, Gg, Gg, Gg, Gg, Gg, Gg, Gg, Gg, Gg
Gg, Gg, Gg, Gg, Gg, Gg, Gg, Gg, Gg, Gg, Gg, Gg, Gg, Gg, Gg, Gg, Gg, Gg, Gg, Gg, Gg, Gg, Gg, Gg, Gg, Gg, Gg, Gg, Gg, Gg, Gg, Gg, Gg, Gg, Gg, Gg, Gg, Gg, Gg, Gg, Gg, Gg, Gg, Gg, Gg, Gg, Gg, Gg, Gg, Gg, Gg, Gg, Gg, Gg, Gg, Gg, Gg, Gg, Gg, Gg, Gg, Gg, Gg, Gg
Gg, Gg, Gg, Gg, Gg, Gg, Gg, Gg, Gg, Gg, Gg, Gg, Gg, Gg, Gg, Gg, Gg, Gg, Gg, Gg, Gg, Gg, Gg, Gg, Gg, Gg, Gg, Gg, Gg, Gg, Gg, Gg, Gg, Gg, Gg, Gg, Gg, Gg, Gg, Gg, Gg, Gg, Gg, Gg, Gg, Gg, Gg, Gg, Gg, Gg, Gg, Gg, Gg, Gg, Gg, Gg, Gg, Gg, Gg, Gg, Gg, Gg, Gg, Gg
Gg, Gg, Gg, Gg, Gg, Gg, Gg, Gg, Gg, Gg, Gg, Gg, Gg, Gg, Gg, Gg, Gg, Gg, Gg, Gg, Gg, Gg, Gg, Gg, Gg, Gg, Gg, Gg, Gg, Gg, Gg, Gg, Gg, Gg, Gg, Gg, Gg, Gg, Gg, Gg, Gg, Gg, Gg, Gg, Gg, Gg, Gg, Gg, Gg, Gg, Gg, Gg, Gg, Gg, Gg, Gg, Gg, Gg, Gg, Gg, Gg, Gg, Gg, Gg
Gg, Gg, Gg, Gg, Gg, Gg, Gg, Gg, Gg, Gg, Gg, Gg, Gg, Gg, Gg, Gg, Gg, Gg, Gg, Gg, Gg, Gg, Gg, Gg, Gg, Gg, Gg, Gg, Gg, Gg, Gg, Gg, Gg, Gg, Gg, Gg, Gg, Gg, Gg, Gg, Gg, Gg, Gg, Gg, Gg, Gg, Gg, Gg, Gg, Gg, Gg, Gg, Gg, Gg, Gg, Gg, Gg, Gg, Gg, Gg, Gg, Gg, Gg, Gg
Gg, Gg, Gg, Gg, Gg, Gg, Gg, Gg, Gg, Gg, Gg, Gg, Gg, Gg, Gg, Gg, Gg, Gg, Gg, Gg, Gg, Gg, Gg, Gg, Gg, Gg, Gg, Gg, Gg, Gg, Gg, Gg, Gg, Gg, Gg, Gg, Gg, Gg, Gg, Gg, Gg, Gg, Gg, Gg, Gg, Gg, Gg, Gg, Gg, Gg, Gg, Gg, Gg, Gg, Gg, Gg, Gg, Gg, Gg, Gg, Gg, Gg, Gg, Gg
Gg, Gg, Gg, Gg, Gg, Gg, Gg, Gg, Gg, Gg, Gg, Gg, Gg, Gg, Gg, Gg, Gg, Gg, Gg, Gg, Gg, Gg, Gg, Gg, Gg, Gg, Gg, Gg, Gg, Gg, Gg, Gg, Gg, Gg, Gg, Gg, Gg, Gg, Gg, Gg, Ch, Gg, Gg, Gg, Gg, Gg, Gg, Gg, Gg, Gg, Gg, Gg, Gg, Gg, Gg, Gg, Gg, Gg, Gg, Gg, Gg, Gg, Gg, Gg
Gg, Gg, Gg, Gg, Gg, Gg, Gg, Gg, Gg, Gg, Gg, Gg, Gg, Gg, Gg, Gg, Gg, Gg, Gg, Gg, Gg, Gg, Gg, Gg, Gg, Gg, Gg, Gg, Gg, Gg, Gg, Gg, Gg, Gg, Gg, Gg, Ch, Gg, Ch, Ch, Rrc, Ch, Ch, Ch, Ch, Gg, Ch, Gg, Gg, Gg, Gg, Gg, Gg, Gg, Gg, Gg, Gg, Gg, Gg, Gg, Gg, Gg, Gg, Gg
Gg, Gg, Gg, Gg, Gg, Gg, Gg, Gg, Gg, Gg, Gg, Gg, Gg, Gg, Gg, Gg, Gg, Gg, Gg, Gg, Gg, Gg, Gg, Gg, Gg, Gg, Gg, Gg, Gg, Gg, Ch, Gg, Ch, Ch, Ch, Ch, Rrc, Ch, Rrc, Rrc, Rrc, Rrc, Rrc, Rrc, Rrc, Ch, Rrc, Ch, Ch, Ch, Ch, Gg, Ch, Gg, Gg, Gg, Gg, Gg, Gg, Gg, Gg, Gg, Gg, Gg
Gg, Gg, Gg, Gg, Gg, Gg, Gg, Gg, Gg, Gg, Gg, Gg, Gg, Gg, Gg, Gg, Gg, Gg, Gg, Gg, Gg, Gg, Gg, Gg, Ch, Gg, Ch, Ch, Ch, Ch, Rrc, Ch, Rrc, Rrc, Rrc, Rrc, Rrc, Rrc, Rrc, Rrc, Rrc, Rrc, Rrc, Rrc, Rrc, Rrc, Rrc, Rrc, Rrc, Rrc, Rrc, Ch, Rrc, Ch, Ch, Gg, Gg, Gg, Gg, Gg, Gg, Gg, Gg, Gg
Gg, Gg, Gg, Gg, Gg, Gg, Gg, Gg, Gg, Gg, Gg, Gg, Gg, Gg, Gg, Gg, Gg, Gg, Gg, Gg, Ch, Ch, Ch, Ch, Rrc, Ch, Rrc, Rrc, Rrc, Rrc, Rrc, Rrc, Rrc, Rrc, Rrc, Rrc, Rrc, Rrc, Rrc, Rrc, Rrc, Rrc, Rrc, Rrc, Rrc, Rrc, Rrc, Rrc, Rrc, Rrc, Rrc, Rrc, Rrc, Rrc, Rrc, Ch, Gg, Gg, Gg, Gg, Gg, Gg, Gg, Gg
Gg, Gg, Gg, Gg, Gg, Gg, Gg, Gg, Gg, Gg, Gg, Gg, Gg, Gg, Gg, Gg, Gg, Gg, Gg, Ch, Rrc, Rrc, Rrc, Rrc, Rrc, Rrc, Rrc, Rrc, Rrc, Rrc, Rrc, Rrc, Rrc, Rrc, Rrc, Rrc, Rrc, Rrc, Rrc, Rrc, Rrc, Rrc, Rrc, Rrc, Rrc, Rrc, Rrc, Rrc, Rrc, Rrc, Rrc, Rrc, Rrc, Rrc, Rrc, Ch, Ch, Gg, Gg, Gg, Gg, Gg, Gg, Gg
Gg, Gg, Gg, Gg, Gg, Gg, Gg, Gg, Gg, Gg, Gg, Gg, Gg, Gg, Gg, Gg, Gg, Gg, Ch, Ch, Rrc, Rrc, Rrc, Rrc, Rrc, Rrc, Rrc, Rrc, Rrc, Rrc, Rrc, Rrc, Rrc, Rrc, Rrc, Rrc, Rrc, Rrc, Rrc, Rrc, Rrc, Rrc, Rrc, Rrc, Rrc, Rrc, Rrc, Rrc, Rrc, Rrc, Rrc, Rrc, Rrc, Rrc, Rrc, Rrc, Rrc, Ch, Gg, Gg, Gg, Gg, Gg, Gg
Gg, Gg, Gg, Gg, Gg, Gg, Gg, Gg, Gg, Gg, Gg, Gg, Gg, Gg, Gg, Gg, Gg, Ch, Rrc, Rrc, Rrc, Rrc, Rrc, Rrc, Rrc, Rrc, Rrc, Rrc, Rrc, Rrc, Rrc, Rrc, Rrc, Rrc, Rrc, Rrc, Rrc, Rrc, Rrc, Rrc, Rrc, Rrc, Rrc, Rrc, Rrc, Rrc, Rrc, Rrc, Rrc, Rrc, Rrc, Rrc, Rrc, Rrc, Rrc, Rrc, Rrc, Ch, Ch, Gg, Gg, Gg, Gg, Gg
Gg, Gg, Gg, Gg, Gg, Gg, Gg, Gg, Gg, Gg, Gg, Gg, Gg, Gg, Ch, Gg, Ch, Ch, Rrc, Rrc, Rrc, Rrc, Rrc, Rrc, Rrc, Rrc, Rrc, Rrc, Rrc, Rrc, Rrc, Rrc, Rrc, Rrc, Rrc, Rrc, Rrc, Rrc, Rrc, Rrc, Rrc, Rrc, Rrc, Rrc, Rrc, Rrc, Rrc, Rrc, Rrc, Rrc, Rrc, Rrc, Rrc, Rrc, Rrc, Rrc, Rrc, Rrc, Rrc, Ch, Ch, Gg, Gg, Gg
Gg, Gg, Gg, Gg, Gg, Gg, Gg, Gg, Gg, Gg, Gg, Gg, Ch, Ch, Rrc, Ch, Rrc, Rrc, Rrc, Rrc, Rrc, Rrc, Rrc, Rrc, Rrc, Rrc, Rrc, Rrc, Rrc, Rrc, Rr, Rr, Rr, Rrc, Rr, Rrc, Rrc, Rrc, Rrc, Rrc, Rrc, Rrc, Rrc, Rrc, Rrc, Rrc, Rrc, Rrc, Rrc, Rrc, Rrc, Rrc, Rrc, Rrc, Rrc, Rrc, Rrc, Rrc, Rrc, Rrc, Ch, Gg, Gg, Gg
Gg, Gg, Gg, Gg, Gg, Gg, Gg, Gg, Gg, Gg, Ch, Ch, Rrc, Rrc, Rrc, Rrc, Rrc, Rrc, Rrc, Rrc, Rrc, Rrc, Rrc, Rrc, Rrc, Rrc, Rrc, Rrc, Rr, Rr, Rr, Rr, Rr, Rr, Rr, Rr, Rr, Rrc, Rrc, Rrc, Rrc, Rrc, Rrc, Rrc, Rrc, Rrc, Rrc, Rrc, Rrc, Rrc, Rrc, Rrc, Rrc, Rrc, Rrc, Rrc, Rrc, Rrc, Rrc, Rrc, Rrc, Ch, Ch, Gg
Gg, Gg, Gg, Gg, Gg, Gg, Gg, Gg, Gg, Ch, Rrc, Rrc, Rrc, Rrc, Rrc, Rrc, Rrc, Rrc, Rrc, Rrc, Rrc, Rrc, Rrc, Rrc, Rr, Rr, Rr, Rr, Rr, Rr, Rr, Rr, Rr, Rr, Rr, Rr, Rr, Rrc, Rrc, Rrc, Rrc, Rrc, Rrc, Rrc, Rrc, Rrc, Rrc, Rrc, Rrc, Rrc, Rrc, Rrc, Rrc, Rrc, Rrc, Rrc, Rrc, Rrc, Rrc, Rrc, Rrc, Rrc, Ch, Gg
Gg, Gg, Gg, Gg, Gg, Gg, Gg, Gg, Ch, Ch, Rrc, Rrc, Rrc, Rrc, Rrc, Rrc, Rrc, Rrc, Rrc, Rrc, Rrc, Rrc, Rrc, Rr, Rr, Rr, Rr, Rr, Rr, Rr, Xoc, Xoc, Xoc, Rr, Rr, Rr, Rr, Rr, Rr, Rrc, Rrc, Rrc, Rrc, Rrc, Rrc, Rrc, Rrc, Rrc, Rrc, Rrc, Rrc, Rrc, Rrc, Rrc, Rrc, Rrc, Rrc, Rrc, Rrc, Rrc, Rrc, Rrc, Rrc, Ch
Gg, Gg, Gg, Gg, Gg, Gg, Wog, Ch, Rrc, Rrc, Rrc, Rrc, Rrc, Rrc, Rrc, Rrc, Rrc, Rrc, Rrc, Rrc, Rrc, Rrc, Rr, Rr, Rr, Rr, Rr, Rr, Xoc, Xoc, Ior, Ior, Iwr, Xoc, Xoc, Rr, Rr, Rr, Rr, Rr, Rrc, Rrc, Rrc, Rrc, Rrc, Rrc, Rrc, Rrc, Rrc, Rrc, Rrc, Rrc, Rrc, Rrc, Rrc, Rrc, Rrc, Rrc, Rrc, Rrc, Rrc, Rrc, Rrc, Rrc
Gg, Gg, Gg, Gg, Ch, Wog^Bsb|, Ch, Ch, Rrc, Rrc, Rrc, Rrc, Rrc, Rrc, Rrc, Rrc, Rrc, Rrc, Rrc, Rrc, Rrc, Rr, Rr, Rr, Rr, Rr, Rr, Rr, Xoc, Ior, Iwr, Ior, Iwr, Ior, Ior, Xoc, Rr, Rr, Rr, Rr, Rrc, Rrc, Rrc, Rrc, Rrc, Rrc, Rrc, Rrc, Rrc, Rrc, Rrc, Rrc, Rrc, Rrc, Rrc, Rrc, Rrc, Rrc, Rrc, Rrc, Rrc, Rrc, Rrc, Rrc
