Md^Xm, Md^Xm, Gll, Gs^Fms, Gll^Fmf, Md, Hhd, Rp, Rp, Mm, Gg, Gg, Gll, Md, Mm, Mm, Mm, Md, Md, Hh, Mm, Mm, Mm, Mm, Mm, Mm, Mm, Mm, Md^Xm, Md^Xm, Wo, Wo, Md^Xm, Md^Xm, Md^Xm, Md^Xm, Md^Xm, Md^Xm, Md^Xm, Mm, Mm, Md^Xm, Md^Xm, Mm, Md^Xm, Mm, Md^Xm, Md^Xm, Md^Xm, Md^Xm, Mm, Md^Xm, Md^Xm, Md^Xm, Md^Xm, Mm, Mm, Mm, Mm, Mm, Md^Xm, Md^Xm, Mm, Mm
Mm, Mm, Md, Gll^Fmf, Gll^Fmf, Hhd, Hh, Gg, Gg, Mm, Gs^Fms, Gs^Fms, Gll^Fmf, Md^Xm, Md^Xm, Mm, Mm, Mm, Md^Xm, Mm, Mm, Mm, Md^Xm, Mm, Mm, Md^Xm, Mm, Mm, Ww, Md, Wo, Wo, Md^Xm, Mm, Mm, Mm, Mm, Md^Xm, Mm, Md^Xm, Md^Xm, Md^Xm, Md^Xm, Md^Xm, Md^Xm, Md^Xm, Mm, Md^Xm, Mm, Mm, Mm, Mm, Mm, Mm, Md^Xm, Md^Xm, Md^Xm, Md^Xm, Md^Xm, Md^Xm, Mm, Mm, Md^Xm, Md^Xm
Mm, Mm, Mm, Md, Hh, Hh, Mm, Mm, Gg, Mm, Mm, Md, Gll, Gll^Fmf, Md, Md^Xm, Mm, Md^Xm, Mm, Md^Xm, Md^Xm, Md^Xm, Md^Xm, Mm, Mm, Md^Xm, Ww, Ww, Wo, Wo, Ww, Md^Xm, Md^Xm, Md^Xm, Mm, Mm, Md^Xm, Md^Xm, Md^Xm, Md^Xm, Md^Xm, Md^Xm, Md^Xm, Mm, Mm, Mm, Mm, Mm, Ms^Xm, Mm, Mm, Mm, Mm, Mm, Mm, Mm, Mm, Mm, Mm, Mm, Md^Xm, Md^Xm, Mm, Md^Xm
Md^Xm, Md^Xm, Mm, Mm, Hhd, Hhd, Mm, Mm, Gg, Gg, Gg, Rp, Md, Gll, Md, Md, Mm, Mm, Mm, Md^Xm, Mm, Md^Xm, Mm, Md^Xm, Wo, Wo, Ww, Wo, Gg, Gll^Fmf, Rb, Ww, Md^Xm, Mm, Mm, Mm, Md^Xm, Md^Xm, Mm, Mm, Ms^Xm, Mm, Ms^Xm, Ms^Xm, Ms^Xm, Ms^Xm, Ms^Xm, Ms^Xm, Ms^Xm, Ms^Xm, Ms^Xm, Mm, Ms^Xm, Mm, Mm, Mm, Mm, Mm, Md^Xm, Md^Xm, Mm, Md^Xm, Md^Xm, Mm
Md^Xm, Mm, Mm, Mm, Mm, Gs^Fms, Gs^Fms, Gs^Fms, Gs^Fms, Gg, Gg, Rp, Md, Hhd, Gll, Md, Md, Mm, Mm, Md^Xm, Mm, Mm, Mm, Mm, Wo, Ww, Ww, Gg, Md, Md, Md, Ww, Md^Xm, Mm, Md^Xm, Md^Xm, Mm, Mm, Mm, Mm, Md^Xm, Ms^Xm, Md^Xm, Mm, Mm, Mm, Mm, Mm, Mm, Ms^Xm, Ms^Xm, Ms^Xm, Ms^Xm, Ms^Xm, Ms^Xm, Mm, Md^Xm, Md^Xm, Md^Xm, Md^Xm, Md^Xm, Md^Xm, Md^Xm, Md^Xm
Mm, Mm, Mm, Mm, Mm, Mm, Mm, Gs^Fms, Gs^Fms, Gg, Hh, Gg, Rp, Hhd, Md, Md, Gs^Fms, Md^Xm, Md^Xm, Md^Xm, Md^Xm, Mm, Ww, Ww, Ww, Ww, Ww, Gs^Fms, Md^Xm, Md, Ww, Ww, Md^Xm, Md^Xm, Mm, Mm, Mm, Mm, Mm, Mm, Md^Xm, Md^Xm, Md^Xm, Mm, Hh, Hh, Mm, Mm, Mm, Mm, Mm, Mm, Md^Xm, Mm, Md^Xm, Md^Xm, Md^Xm, Md^Xm, Md^Xm, Md^Xm, Mm, Mm, Mm, Mm
Md^Xm, Mm, Mm, Md^Xm, Mm, Mm, Mm, Gg, Gg, Gg, Hh, Gg, Rp, Gg, Mm, Mm, Gs^Fms, Mm, Mm, Md^Xm, Ww, Ww, Ww, Gg, Gg, Ww, Ww, Gs^Fms, Md^Xm, Md^Xm, Ww, Mm, Md^Xm, Md^Xm, Md^Xm, Mm, Mm, Mm, Gs^Fms, Mm, Md^Xm, Md^Xm, Ww^Ewl, Ww^Ewl, Hh, Mm, Mm, Mm, Wo, Wo, Wo, Wo, Wo, Wo, Mm, Md^Xm, Md^Xm, Ww, Mm, Mm, Mm, Mm, Md^Xm, Md^Xm
Md^Xm, Mm, Mm, Md^Xm, Md^Xm, Mm, Mm, Mm, Mm, Gg, Mm, Hh, Gg, Mm, Mm, Gs^Fms, Gg, Gg, Ww, Ww, Gs^Fms, Gs^Fms, Md^Xm, Md^Xm, Mm, Gs^Fms, Gs^Fms, Ww, Gg, Gs^Fms, Ww, Md^Xm, Md^Xm, Mm, Mm, Mm, Mm, Gs^Fms, Gg, Mm, Ww, Ww^Ewl, Mm, Mm, Hh, Mm, Mm, Mm, Hh, Wo, Wo, Wo, Wo, Wo, Md^Xm, Mm, Wo^Es, Wwr, Md^Xm, Md^Xm, Md^Xm, Md^Xm, Mm, Mm
Mm, Mm, Mm, Mm, Md^Xm, Md^Xm, Md^Xm, Mm, Mm, Mm, Mm, Mm, Mm, Gg, Rp, Gs^Fms, Ww, Ww, Hh, Gg, Gg, Gg, Mm, Mm, Md^Xm, Mm, Gg, Ww, Ww, Gg, Ww, Gg, Md^Xm, Mm, Mm, Mm, Hh, Hh^Vhh, Gg, Ww, Ww, Mm, Mm, Mm, Mm, Mm, Mm, Mm, Mm, Gs^Fms, Gs^Fms, Wo, Wo, Wo, Wo, Wo, Gg, Gg, Mm, Mm, Md^Xm, Mm, Mm, Mm
Mm, Mm, Md^Xm, Md^Xm, Mm, Md^Xm, Md^Xm, Mm, Mm, Mm, Ww, Mm, Ww, Hh, Ww, Rp, Rp, Ww, Mm, Hh, Hh, Mm, Mm, Mm, Mm, Mm, Md^Xm, Gg, Ww, Ww, Ww, Md^Xm, Md^Xm, Mm, Mm, Md^Xm, Hh, Gg, Ww, Ww, Mm, Mm, Mm, Mm, Hh, Hh, Mm, Mm, Mm, Mm, Mm, Gg, Hh, Wo, Wo, Gs^Fms, Gs^Fms, Hh, Mm, Mm, Md^Xm, Mm, Mm, Mm
Md^Xm, Md^Xm, Mm, Mm, Mm, Mm, Mm, Md^Xm, Md^Xm, Ww, Ww, Ww, Ww, Ww, Ww, Ww, Gg, Rp, Gg, Mm, Hh, Hh, Hh, Mm, Mm, Mm, Md^Xm, Gs^Fms, Gs^Fms, Ww, Ww, Ww, Ww, Md^Xm, Gg, Gg, Gg, Mm, Ww, Ww, Mm, Mm, Mm, Hh, Mm, Mm, Mm, Hh, Hh, Mm, Hh, Mm, Hh, Mm, Ww^Es, Gg, Mm, Hh, Mm, Mm, Md^Xm, Md^Xm, Mm, Mm
Mm, Mm, Mm, Mm, Mm, Mm, Gs^Fms, Gs^Fms, Ww, Ww, Md^Xm, Mm, Mm, Ww, Mm, Hh, Mm, Gg, Gg, Gg, Gg, Hh, Mm, Mm, Mm, Mm, Md^Xm, Gg, Gg, Md^Xm, Mm, Ww, Ww, Ww, Ww, Wwr, Ww^Es, Ww, Mm, Mm, Mm, Mm, Hh, Mm, Mm, Mm, Hh, Mm, Mm, Hh, Hh, Hh, Mm, Wwr, Ww^Es, Mm, Md^Xm, Mm, Mm, Mm, Md^Xm, Mm, Mm, Mm
Md^Xm, Md^Xm, Md^Xm, Mm, Mm, Md^Xm, Gg, Ww, Mm, Mm, Mm, Md^Xm, Md^Xm, Mm, Mm, Mm, Mm, Mm, Mm, Rp, Mm, Gg, Mm, Mm, Mm, Mm, Md^Xm, Mm, Mm, Mm, Md^Xm, Mm, Gg, Gg, Ww, Ww^Es, Mm, Mm, Mm, Mm, Mm, Mm, Mm, Mm, Cte, Hh, Cte, Cte, Rp, Hh^Vhh, Hh, Mm, Mm, Ww^Es, Mm, Md^Xm, Md^Xm, Md^Xm, Md^Xm, Md^Xm, Md^Xm, Mm, Mm, Mm
Mm, Md^Xm, Wo, Md^Xm, Wo, Gg, Ww, Ww, Mm, Mm, Mm, Mm, Mm, Mm, Mm, Mm, Mm, Mm, Mm, Rp, Gg, Gg, Mm, Mm, Mm, Mm, Mm, Mm, Mm, Mm, Md^Xm, Md^Xm, Md^Xm, Gs^Fms, Mm, Mm, Mm, Mm, Mm, Md^Xm, Mm, Mm, Mm, Hh, Cte, Rp, Kte, Rp, Cte, Hh, Mm, Mm, Ww, Ww^Es, Mm, Md^Xm, Md^Xm, Md^Xm, Md^Xm, Mm, Mm, Mm, Mm, Mm
Wo, Wo, Ww, Wo, Ww, Ww, Mm, Hh, Hh, Hh, Mm, Mm, Mm, Mm, Mm, Mm, Mm, Mm, Gg, Rp, Gg, Gg, Hh, Mm, Mm, Mm, Mm, Mm, Mm, Mm, Mm, Md^Xm, Mm, Mm, Mm, Mm, Hh, Mm, Mm, Mm, Mm, Mm, Mm, Hh, Cte, Cte, Cte, Cte, Rp, Hh, Mm, Mm, Ww, Mm, Mm, Md^Xm, Mm, Md^Xm, Md^Xm, Mm, Mm, Mm, Mm, Mm
Wo, Ww, Mm, Ww, Mm, Mm, Mm, Hh, Mm, Hh, Gg, Mm, Gg, Gg, Hh, Hh, Hh, Gg, Hh, Gg, Hh, Hh, Mm, Hh, Hh, Mm, Mm, Mm, Md^Xm, Mm, Mm, Md^Xm, Mm, Mm, Mm, Hh, Mm, Mm, Mm, Mm, Mm, Mm, Mm, Mm, Mm, Rp, Rp, Cte, Mm, Mm, Mm, Mm, Ww, Mm, Mm, Mm, Md^Xm, Md^Xm, Mm, Mm, Mm, Mm, Mm, Mm
Wo, Md^Xm, Mm, Mm, Mm, Mm, Hh, Hh, Gg, Gg, Rp, Rp, Mm, Rp, Hh, Gg, Hh, Hh, Mm, Mm, Mm, Mm, Mm, Mm, Mm, Mm, Md^Xm, Mm, Mm, Mm, Mm, Md^Xm, Mm, Mm, Mm, Hh, Hh, Mm, Mm, Mm, Mm, Mm, Mm, Hh, Hh, Mm, Mm, Rr, Mm, Mm, Mm, Mm, Ww^Es, Mm, Md^Xm, Md^Xm, Gg, Mm, Mm, Mm, Mm, Mm, Mm, Mm
Wo, Md^Xm, Mm, Mm, Mm, Mm, Hh, Hh, Gg, Rp, Mm, Mm, Mm, Mm, Hh, Hh, Mm, Mm, Mm, Mm, Mm, Mm, Md^Xm, Md^Xm, Mm, Mm, Mm, Mm, Mm, Mm, Mm, Md^Xm, Md^Xm, Mm, Mm, Mm, Mm, Mm, Mm, Mm, Hh, Mm, Mm, Mm, Mm, Mm, Rr, Rr, Mm, Mm, Mm, Mm, Wwr, Ww^Es, Gs^Fms, Gs^Fms, Gg, Hh, Mm, Mm, Mm, Mm, Mm, Mm
Wo, Md^Xm, Mm, Mm, Mm, Mm, Mm, Gg, Re, Mm, Mm, Mm, Mm, Mm, Mm, Hh, Mm, Mm, Mm, Mm, Md^Xm, Md^Xm, Mm, Mm, Mm, Mm, Mm, Mm, Mm, Mm, Mm, Mm, Md^Xm, Mm, Mm, Mm, Mm, Mm, Mm, Hh, Mm, Hh, Mm, Mm, Mm, Mm, Rr, Mm, Mm, Mm, Mm, Mm, Wwr, Ww^Es, Mm, Hh, Hh, Mm, Mm, Mm, Mm, Mm, Gg, Gg
Ww, Md^Xm, Mm, Mm, Mm, Mm, Mm, Gg, Gg, Hh, Hh, Mm, Mm, Mm, Mm, Mm, Md^Xm, Mm, Md^Xm, Mm, Mm, Mm, Mm, Mm, Mm, Mm, Md^Xm, Mm, Md^Xm, Md^Xm, Md^Xm, Mm, Md^Xm, Mm, Mm, Mm, Mm, Mm, Mm, Mm, Mm, Mm, Mm, Mm, Mm, Mm, Hh, Mm, Md, Md, Md, Md, Md, Ww^Es, Mm, Mm, Mm, Mm, Mm, Mm, Gg, Gg, Gg, Gg
Ww, Md^Xm, Md^Xm, Mm, Mm, Mm, Hh, Hh, Gg, Mm, Mm, Mm, Mm, Mm, Mm, Mm, Mm, Md^Xm, Mm, Md^Xm, Md^Xm, Md^Xm, Md^Xm, Md^Xm, Md^Xm, Md^Xm, Mm, Md^Xm, Md^Xm, Mm, Mm, Md^Xm, Mm, Mm, Mm, Mm, Mm, Mm, Mm, Mm, Mm, Mm, Mm, Mm, Mm, Mm, Rr, Mm, Hh, Gd, Hhd, Md, Gd, Ww^Es, Ww^Es, Gs^Fms, Hh, Hh, Gg, Gg, Gg, Gg, Gg, Gg
Md^Xm, Mm, Mm, Mm, Mm, Mm, Mm, Hh, Mm, Gg, Gg, Hh, Mm, Mm, Hh, Mm, Mm, Md^Xm, Mm, Mm, Mm, Mm, Mm, Mm, Mm, Mm, Md^Xm, Mm, Mm, Mm, Md^Xm, Mm, Mm, Mm, Mm, Mm, Mm, Mm, Mm, Hh^Vhh, Mm, Mm, Mm, Mm, Mm, Mm, Mm, Rp, Gs, Gs, Gs, Hhd, Gs, Gs, Gs, Ww^Ewl, Ww, Gg, Gg, Gg, Gg, Gg, Gg, Gg
Ww^Es, Mm, Md^Xm, Mm, Gg, Mm, Mm, Mm, Mm, Mm, Gg, Hh, Mm, Hh, Gg, Mm, Mm, Mm, Md^Xm, Mm, Md^Xm, Md^Xm, Mm, Mm, Md^Xm, Mm, Mm, Mm, Mm, Mm, Mm, Mm, Mm, Mm, Mm, Mm, Mm, Mm, Mm, Hh, Mm, Mm, Mm, Mm, Hh^Vhh, Mm, Gg, Rp, Gg, Gs^Fms, Hh, Gs, Hh, Gs, Gs, Gs, Ww, Gg, Gg, Gg, Gg, Gg, Gg, Gg
Gs^Fds, Wwr, Wo^Es, Gs^Fds, Md^Xm, Gg, Gg, Mm, Mm, Hh, Hh, Gg, Gg, Hh, Hh, Mm, Mm, Mm, Mm, Mm, Mm, Mm, Md^Xm, Mm, Mm, Md^Xm, Mm, Mm, Md^Xm, Md^Xm, Mm, Mm, Mm, Mm, Mm, Mm, Gs^Fms, Mm, Hh, Hh, Gg, Hh, Hh, Hh, Gg, Gg, Rp, Gg, Gg, Gs^Fms, Gs^Fms, Hh, Hh, Gg, Gs, Ww, Gg, Gg, Gg, Gg, Gg, Gg, Gg, Gg
Gs^Fds, Wo^Es, Wo, Wo, Wo^Es, Md^Xm, Wwr, Gs^Fms, Hh, Hh, Hh, Gg, Gg, Rp, Rp, Mm, Mm, Mm, Hh, Mm, Mm, Mm, Md^Xm, Mm, Mm, Mm, Mm, Mm, Mm, Mm, Mm, Mm, Mm, Mm, Mm, Gs^Fms, Hh, Hh, Hh, Gs^Fms, Rp, Gg, Gg, Hh, Gg, Gg, Rp, Gg, Gs, Gg, Gs^Fms, Gg, Gll, Gg, Ww, Ww, Gs, Gg, Gg, Gg, Gg, Gg, Gg, Gg
Gs^Fms, Md^Xm, Mm, Mm, Mm, Wwr, Ww^Es, Wo^Es, Wo, Wo, Wo^Es, Hh, Hh, Gg, Mm, Rp, Rp, Rp, Gs^Fms, Gs^Fms, Gs^Fms, Mm, Mm, Mm, Mm, Md^Xm, Gs^Fms, Mm, Gs^Fms, Mm, Gs^Fms, Mm, Mm, Mm, Hh, Hh, Gs^Fms, Gs^Fms, Gs^Fms, Gs^Fms, Gg, Rp, Gg, Gg, Gg, Gg, Gll, Gs, Gs^Fms, Gs^Fms, Rb, Gs^Fms, Re, Gll, Ww^Es, Gs, Gg, Gs, Gg, Gg, Gg, Gg, Gg, Gg
Gs^Fms, Gs^Fms, Mm, Mm, Md^Xm, Gs^Fds, Mm, Gg, Gs^Fds, Sm, Wwr, Wo^Es, Mm, Mm, Mm, Mm, Rp, Gg, Mm, Gg, Gg, Gs^Fms, Mm, Mm, Hh, Gg, Gg, Gs^Fms, Mm, Gs^Fms, Gg, Gs^Fms, Gg, Gg, Gg, Gg, Gg, Gg, Gg, Gg, Rp, Rp, Rp, Rr, Rr, Rp, Re, Re, Gs^Fms, Rb, Sm, Rb, Ss, Ss, Ss, Gll, Gll, Gg, Gg, Gg, Gg, Gg, Gg, Gg
Hh, Gg, Gg, Mm, Mm, Mm, Mm, Mm, Mm, Ss, Ss, Wwr, Mm, Mm, Mm, Mm, Mm, Rp, Hh, Mm, Mm, Mm, Mm, Mm, Mm, Hh, Mm, Mm, Gg, Gg, Gs^Fds, Gg, Gg, Gg, Gg, Gg, Gg^Eff, Gg, Gg, Gg, Gg, Gg, Gg, Gg, Gg, Rr, Gs^Fms, Gs^Fms, Ss, Sm, Ss, Ss, Wo, Wo, Sm, Re, Re, Gll, Gg, Gg, Gg, Gg, Gg, Gg
Mm, Mm, Mm, Hh, Hh, Mm, Mm, Hh, Mm, Mm, Gg, Ww^Es, Gs^Fds, Gg, Gg, Mm, Hh, Gg, Gg, Hh, Hh, Hh, Gg, Mm, Mm, Hh, Gg, Gg, Gs^Fds, Gs^Fds, Gg, Gs^Fds, Gg, Gg, Gg^Eff, Gg^Eff, Gg^Gvs, Gg^Eff, Gg^Eff, Gg, Gg, Gs, Gs^Fms, Gg, Gll, Gll, Gs^Fms, Gs^Fms, Ss, Gg, Gg, Gg, Gd, Rb, Rb, Rb, Re, Gll, Gg, Gg, Gg, Gg, Gg, Gg
Gg, Gg, Gg, Mm, Gg, Hh, Gs^Fds, Hh, Gs^Fds, Gg, Gg, Ww, Ww, Gs^Fds, Hh, Hh, Hh, Gg, Gg, Hh, Gg, Hh, Hh, Gg, Gg, Gg, Gg, Gg, Gg, Gs^Fds, Gg, Gg, Gg, Gg, Gg^Gvs, Gg^Gvs, Gg^Gvs, Gg^Gvs, Gs^Vh, Gg^Eff, Gg, Gs, Hh, Gs^Fms, Gs, Gs, Gll, Gs^Fms, Wo, Gg, Gg, Gs, Gs, Gd, Rb, Re, Rb, Re, Gg, Gg, Gg, Gg, Gg, Gg
Gg, Gg, Gg, Gs^Fds, Hh, Hh, Gg, Gg, Gg, Hh, Gg, Gg, Gg, Ww, Ww^Es, Wwr, Ww^Es, Ww, Ww, Gg, Gg, Gs^Fms, Gs^Fms, Gg, Gg, Gg, Gg, Gg, Rd, Gg, Rb, Rb, Gg, Rd, Gg^Eff, Gg^Gvs, Gg^Gvs, Gg^Gvs, Gg^Gvs, Gs, Gg^Gvs, Gg, Hh, Gs^Fms, Gs, Gs, Gs, Gs^Fms, Gll, Wo, Ss, Gs, Gd, Rb, Sm, Rb, Gll, Gll, Gg, Gg, Gg, Gg, Gg, Gg
Gg, Gg, Gg, Gs^Fds, Gg, Gg, Gg, Gg, Gg, Gg, Gg, Gg, Gg, Gg, Gg, Ww^Es, Gg, Ww, Ww^Bw/r, Ww^Bw/r, Ww, Ss, Gs^Fms, Gs^Fms, Gg, Rb, Gg, Rd, Gg, Gg, Gg, Gg, Gg, Gg, Gg, Gg^Eff, Gg, Gg^Gvs, Gg^Gvs, Gs, Gg^Gvs, Gg, Gg, Gs^Fms, Gg, Gs, Rp, Gs^Fms, Gs^Fms, Gll, Gs^Fms, Ss, Ss, Rb, Rb, Gll^Fmf, Sm, Gll, Gg, Gg, Gg, Gg, Gg, Gg
Rb, Rb, Rd, Rd, Rd, Re, Rd, Re, Re, Rd, Rd, Rd, Rd, Gg, Rd, Rb, Rd, Rb, Gg, Ww, Ww, Ss, Ss, Wo, Wo, Gg, Ww^Es, Gg, Ww^Es, Gg, Gg, Gg, Gg, Gg, Hh, Gg, Gg, Gg, Gs^Fms, Gs, Gg, Gg, Gg, Gg, Gg, Gg, Rp, Gg, Gs, Gs^Fms, Gs^Fms, Sm, Ww^Es, Ww^Es, Sm, Sm, Rb, Rb, Gg, Gg, Gg, Gg, Gg, Gg
Gg, Gg, Gg, Gg, Gg, Gg, Gs^Fds, Gg, Gg, Gg, Hh, Gg, Gs^Fds, Rd, Gg, Rd, Gg, Gg, Gg, Gg, Gs^Fms, Sm, Gs^Fms, Ss, Gg, Ww^Es, Gg, Wwr, Wwr, Ww^Es, Ww^Es, Gg, Gg, Gg, Hh, Gs^Fms, Hh, Gs^Fms, Gg, Gg, Ww, Ww, Ww, Gg, Rb, Gg, Rr, Rb, Ch, Re, Ww, Ww, Re, Rb, Rb, Rb, Gs, Re, Gg, Gg, Gg, Gg, Gg, Gg
Gg, Gg, Gg, Gg, Gg, Gg, Gg, Gs^Fds, Gs^Fds, Hh, Gg, Hh, Gg, Gg, Gg, Gg, Gg, Gg, Gg, Gg, Gg, Gs^Fms, Gg, Gg, Gg, Gg, Gg, Gg, Gg, Gg, Gg, Ww, Ww, Gg, Ww, Hh, Ww^Ewl, Gg, Ww^Ewf, Ww, Ww, Ww, Ww^Es, Ww^Es, Wwr, Ch, Ww^Bsb|, Ww^Es, Wwr, Ww^Es, Gg, Gll, Gll, Re, Gll, Gs, Gs, Gs, Gg, Gg, Gg, Gg, Gg, Gg
Gg, Gg, Gg, Gg, Gg, Gg, Gg, Gg, Gg, Gg, Gg, Gg, Gg, Gg, Gg, Gg, Gg, Gg, Gg, Gg, Gg, Gg, Gg, Gg, Gg, Gg, Gg, Gg, Gg, Gg, Gg, Gg, Gg, Gg, Ww, Ww, Gg, Ww^Ewf, Gg, Gg, Gg, Ch, Gg, Gg, Gg, Ww^Es, Rr, Ww^Es, Gg, Gs, Gs, Gs, Gs, Gs, Gs, Gs, Gg, Gs, Gg, Gg, Gg, Gg, Gg, Gg
Gg, Gg, Gg, Gg, Gg, Gg, Gg, Gg, Gg, Gg, Gg, Gg, Gg, Gg, Gg, Gg, Gg, Gg, Gg, Gg, Gg, Gg, Gg, Gg, Gg, Gg, Gg, Gg, Gg, Gg, Gg, Gg, Gg, Gg, Hh, Gg, Hh, Gg, Gg, Gg, Gg, Gg, Gg, Gg, Gg, Rr, Gg, Gg, Gg, Gg, Gg, Gg, Hh, Gg, Gg, Gg, Gg, Gg, Gg, Gg, Gg, Gg, Gg, Gg
Gg, Gg, Gg, Gg, Gg, Gg, Gg, Gg, Gg, Gg, Gg, Gg, Gg, Gg, Gg, Gg, Gg, Gg, Gg, Gg, Gg, Gg, Gg, Gg, Gg, Gg, Gg, Gg, Gg, Gg, Gg, Gg, Gg, Gg, Hh, Gs^Fms, Gg, Gs^Fms, Gg, Gg, Ch, Gg, Gg, Gg, Gg, Rrc, Gg, Gg, Gg, Gg, Gg, Gs^Fms, Gs^Fms, Hh, Gg, Gg^Efm, Gg^Efm, Gg^Efm, Gg, Gg, Gg, Gg, Gg, Gg
Gg, Gg, Gg, Gg, Gg, Gg, Gg, Gg, Gg, Gg, Gg, Gg, Gg, Gg, Gg, Gg, Gg, Gg, Gg, Gg, Gg, Gg, Gg, Gg, Gg, Gg, Gg, Gg, Gg, Gg, Gg, Gg, Gg, Gg, Gg, Gg, Ch, Gg, Ch, Ch, Ch, Ch, Ch, Ch, Ch, Rrc, Ch, Gg, Gg, Gg, Gg, Gg, Gg, Gg, Gg, Gg^Efm, Gg^Efm, Gg^Efm, Gg, Gg, Gg, Gg, Gg, Gg
Gg, Gg, Gg, Gg, Gg, Gg, Gg, Gg, Gg, Gg, Gg, Gg, Gg, Gg, Gg, Gg, Gg, Gg, Gg, Gg, Gg, Gg, Gg, Gg, Gg, Gg, Gg, Gg, Gg, Gg, Ch, Gg, Ch, Ch, Ch, Ch, Rrc, Ch, Rrc, Ch, Kh, Ch, Rrc, Rrc, Rrc, Ch, Rrc, Ch, Ch, Ch, Ch, Kh, Ch, Gg, Gg, Gg, Gg, Gg^Efm, Gg, Gg, Gg, Gg, Gg, Gg
Gg, Gg, Gg, Gg, Gg, Gg, Gg, Gg, Gg, Gg, Gg, Gg, Gg, Gg, Gg, Gg, Gg, Gg, Gg, Gg, Gg, Gg, Gg, Gg, Ch, Gg, Ch, Ch, Ch, Ch, Rrc, Ch, Rrc, Rrc, Rrc, Rrc, Rrc, Rrc, Rrc, Ch, Ch, Rrc, Rrc, Rrc, Rrc, Rrc, Rrc, Rrc, Rrc, Rrc, Rrc, Ch, Rrc, Ch, Ch, Gg, Gg, Gg^Efm, Gg, Gg, Gg, Gg, Gg, Gg
Gg, Gg, Gg, Gg, Gg, Gg, Gg, Gg, Gg, Gg, Gg, Gg, Gg, Gg, Gg, Gg, Gg, Gg, Gg, Gg, Ch, Ch, Ch, Ch, Rrc, Ch, Rrc, Rrc, Rrc, Rrc, Rrc, Rrc, Rrc, Rrc, Rrc, Rrc, Rrc, Rrc, Rrc, Rrc, Rrc, Rrc, Rrc, Rrc, Rrc, Rrc, Rrc, Rrc, Rrc, Rrc, Rrc, Rrc, Rrc, Rrc, Rrc, Kh, Ch, Ch, Gg, Gg, Gg, Gg, Gg, Gg
Gg, Gg, Gg, Gg, Gg, Gg, Gg, Gg, Gg, Gg, Gg, Gg, Gg, Gg, Gg, Gg, Gg, Gg, Gg, Ch, Rrc, Rrc, Rrc, Rrc, Rrc, Rrc, Rrc, Rrc, Rrc, Rrc, Rrc, Rrc, Rrc, Rrc, Rrc, Rrc, Rrc, Rrc, Rrc, Rrc, Rrc, Rrc, Rrc, Rrc, Rrc, Rrc, Rrc, Rrc, Rrc, Rrc, Rrc, Rrc, Rrc, Rrc, Rrc, Ch, Ch, Gg, Gg, Gg, Gg, Gg, Gg, Gg
Gg, Gg, Gg, Gg, Gg, Gg, Gg, Gg, Gg, Gg, Gg, Gg, Gg, Gg, Gg, Gg, Gg, Gg, Ch, Ch, Rrc, Rrc, Rrc, Rrc, Rrc, Rrc, Rrc, Rrc, Rrc, Rrc, Rrc, Rrc, Rrc, Rrc, Rrc, Rrc, Rrc, Rrc, Rrc, Rrc, Rrc, Rrc, Rrc, Rrc, Rrc, Rrc, Rrc, Rrc, Rrc, Rrc, Rrc, Rrc, Rrc, Rrc, Rrc, Rrc, Rrc, Ch, Gg, Gg, Gg, Gg, Gg, Gg
Gg, Gg, Gg, Gg, Gg, Gg, Gg, Gg, Gg, Gg, Gg, Gg, Gg, Gg, Gg, Gg, Gg, Ch, Rrc, Rrc, Rrc, Rrc, Rrc, Rrc, Rrc, Rrc, Rrc, Rrc, Rrc, Rrc, Rrc, Rrc, Rrc, Rrc, Rrc, Rrc, Rrc, Rrc, Rrc, Rrc, Rrc, Rrc, Rrc, Rrc, Rrc, Rrc, Rrc, Rrc, Rrc, Rrc, Rrc, Rrc, Rrc, Rrc, Rrc, Rrc, Rrc, Ch, Ch, Gg, Gg, Gg, Gg, Gg
Gg, Gg, Gg, Gg, Gg, Gg, Gg, Gg, Gg, Gg, Gg, Gg, Gg, Gg, Ch, Gg, Ch, Ch, Rrc, Rrc, Rrc, Rrc, Rrc, Rrc, Rrc, Rrc, Rrc, Rrc, Rrc, Rrc, Rrc, Rrc, Rrc, Rrc, Rrc, Rrc, Rrc, Rrc, Rrc, Rrc, Rrc, Rrc, Rrc, Rrc, Rrc, Rrc, Rrc, Rrc, Rrc, Rrc, Rrc, Rrc, Rrc, Rrc, Rrc, Rrc, Rrc, Rrc, Rrc, Ch, Ch, Gg, Gg, Gg
Gg, Gg, Gg, Gg, Gg, Gg, Gg, Gg, Gg, Gg, Gg, Gg, Ch, Ch, Rrc, Ch, Rrc, Rrc, Rrc, Rrc, Rrc, Rrc, Rrc, Rrc, Rrc, Rrc, Rrc, Rrc, Rrc, Rrc, Rr, Rr, Rr, Rrc, Rr, Rrc, Rrc, Rrc, Rrc, Rrc, Rrc, Rrc, Rrc, Rrc, Rrc, Rrc, Rrc, Rrc, Rrc, Rrc, Rrc, Rrc, Rrc, Rrc, Rrc, Rrc, Rrc, Rrc, Rrc, Rrc, Ch, Gg, Gg, Gg
Gg, Gg, Gg, Gg, Gg, Gg, Gg, Gg, Gg, Gg, Ch, Ch, Rrc, Rrc, Rrc, Rrc, Rrc, Rrc, Rrc, Rrc, Rrc, Rrc, Rrc, Rrc, Rrc, Rrc, Rrc, Rrc, Rr, Rr, Rr, Rr, Rr, Rr, Rr, Rr, Rr, Rrc, Rrc, Rrc, Rrc, Rrc, Rrc, Rrc, Rrc, Rrc, Rrc, Rrc, Rrc, Rrc, Rrc, Rrc, Rrc, Rrc, Rrc, Rrc, Rrc, Rrc, Rrc, Rrc, Rrc, Ch, Ch, Gg
Gg, Gg, Gg, Gg, Gg, Gg, Gg, Gg, Gg, Ch, Rrc, Rrc, Rrc, Rrc, Rrc, Rrc, Rrc, Rrc, Rrc, Rrc, Rrc, Rrc, Rrc, Rrc, Rr, Rr, Rr, Rr, Rr, Rr, Rr, Rr, Rr, Rr, Rr, Rr, Rr, Rrc, Rrc, Rrc, Rrc, Rrc, Rrc, Rrc, Rrc, Rrc, Rrc, Rrc, Rrc, Rrc, Rrc, Rrc, Rrc, Rrc, Rrc, Rrc, Rrc, Rrc, Rrc, Rrc, Rrc, Rrc, Ch, Gg
Gg, Gg, Gg, Gg, Gg, Gg, Gg, Gg, Ch, Ch, Rrc, Rrc, Rrc, Rrc, Rrc, Rrc, Rrc, Rrc, Rrc, Rrc, Rrc, Rrc, Rrc, Rr, Rr, Rr, Rr, Rr, Rr, Rr, Xoc, Xoc, Xoc, Rr, Rr, Rr, Rr, Rr, Rr, Rrc, Rrc, Rrc, Rrc, Rrc, Rrc, Rrc, Rrc, Rrc, Rrc, Rrc, Rrc, Rrc, Rrc, Rrc, Rrc, Rrc, Rrc, Rrc, Rrc, Rrc, Rrc, Rrc, Rrc, Ch
Gg, Gg, Gg, Gg, Gg, Gg, Wog, Ch, Rrc, Rrc, Rrc, Rrc, Rrc, Rrc, Rrc, Rrc, Rrc, Rrc, Rrc, Rrc, Rrc, Rrc, Rr, Rr, Rr, Rr, Rr, Rr, Xoc, Xoc, Ior, Ior, Iwr, Xoc, Xoc, Rr, Rr, Rr, Rr, Rr, Rrc, Rrc, Rrc, Rrc, Rrc, Rrc, Rrc, Rrc, Rrc, Rrc, Rrc, Rrc, Rrc, Rrc, Rrc, Rrc, Rrc, Rrc, Rrc, Rrc, Rrc, Rrc, Rrc, Rrc
Gg, Gg, Gg, Gg, Ch, Wog^Bsb|, Ch, Ch, Rrc, Rrc, Rrc, Rrc, Rrc, Rrc, Rrc, Rrc, Rrc, Rrc, Rrc, Rrc, Rrc, Rr, Rr, Rr, Rr, Rr, Rr, Rr, Xoc, Ior, Iwr, Ior, Iwr, Ior, Ior, Xoc, Rr, Rr, Rr, Rr, Rrc, Rrc, Rrc, Rrc, Rrc, Rrc, Rrc, Rrc, Rrc, Rrc, Rrc, Rrc, Rrc, Rrc, Rrc, Rrc, Rrc, Rrc, Rrc, Rrc, Rrc, Rrc, Rrc, Rrc
