Gg, Gg, Gg, Gg, Gg, Gg, Gg, Gg, Gg, Gg, Gg, Gg, Gg, Gg, Gg, Gg, Gg, Gg, Gg, Gg, Gg, Gg, Gg, Gg, Gg, Gg, Gg, Gg, Gg, Gg, Gg, Gg, Gg, Gg, Gg, Gg
Gg, Gg, Gg, Gg, Gg, Gg, Gg, Gg, Gg, Gg, Gg, Gg, Gg, Gg, Gg, Gd^Vo, Gg, Gg, Gg, Gg, Gg, Gg, Gg, Gg, Gg, Gg, Gg, Gg, Gg, Gg, Gg, Gg, Gg, Gg, Gg, Gg
Gg, Gg, Gg, Gg, Gg, Gg, Gg, Gg, Gg, Gg, Gg, Gg, Gg, Gg, Gg, Gg, Gg, Gg, Gg, Gg, Gg, Gg, Gg, Gg, Gg, Gg, Gg, Gg, Gg, Gg, Gd^Vo, Gg, Gg, Gg, Gg, Gg
Gg, Gg, Gg, Gg, Gg, Gg, Gg, Gg, Gd^Vo, Gg, Gg, Gg, Gg, Gg, Gg, Gg, Gg, Gg, Gg, Gg, Gg, Gd^Vo, Gg, Gg, Gg, Gg, Gg, Gg, Gg, Gg, Gg, Gg, Gg, Gg, Gg, Gg
Gg, Gg, Gg, Gg, Gg, Gg, Gg, Gg, Gg, Gg, Gg, Gg, Gg, Gg, Gg, Gg, Gg, Gg, Gd, Gg, Gg, Gg, Gg, Gg, Gg, Gg, Gg, Gg, Gg, Gg, Gg, Gg, Gg, Gg, Gg, Gg
Gg, Gg, Gg, Gg, Gg, Gg, Rr, Gg, Gll, Gg, Gg, Gg, Gg, Co, Co, Co, Co, Ko, Rd, Gd, Gd, Gg, Co, Gd, Gd, Gg, Gg, Gg, Gd^Vo, Gg, Gg, Gg, Gg, Gg, Gg, Gg
Gg, Gg, Gg, Gg, Gg, Gg, Gg, Gd, Gg, Gd, Rr, Gg, Co, Co, Co, Gd^Vo, Gd, Rd, Rd, Re, Re, Co, Re, Re, Rd, Ko, Gd, Gg, Gg, Gg, Gg, Gg, Gg, Gg, Gg, Gg
Gg, Gg, Gg, Gg, Gd^Vo, Gg, Gg, Gg, Gg, Gg, Co, Gd, Rr, Rd, Rd, Co, Rd, Rd, Re, Re, Re, Re, Rd, Re, Re, Rd, Co, Gg, Gg, Gg, Gg, Gg, Gg, Gd^Vo, Gg, Gg
Gg, Gg, Gg, Gg, Gg, Gg, Gg, Gg, Gg, Ko, Rb, Rb, Rb, Rr, Rd, Co, Rd, Re, Ko, Co, Co, Rd, Rd, Rd, Re, Rb, Co, Co, Gg, Gg, Gg, Gg, Gg, Gg, Gg, Gg
Gg, Gg, Gg, Gg, Gg, Gg, Gg, Gg, Co, Gd, Rb, Co, Rb, Rr, Co, Co, Re, Rd, Re, Co, Co, Co, Co, Gd, Re, Rb, Co, Gg, Gg, Gg, Gg, Gg, Gg, Gg, Gg, Gg
Gd^Vo, Gg, Gg, Gg, Gg, Gg, Co, Co, Rb, Rd, Rb, Co, Rb, Rr, Rr, Ko, Re, Re, Rd, Re, Rd, Co, Co, Gd^Vo, Gd, Re, Re, Co, Ko, Gg, Gg, Gg, Gg, Gg, Gg, Gd^Vo
Gg, Gg, Gg, Gg, Gg, Co, Co, Gd^Vo, Gd, Rd, Rb, Co, Ko, Rd, Rd, Rb, Re, Co, Gd, Rd, Gd, Gd, Ko, Co, Gs, Rd, Rd, Rd, Gs, Gd, Gg, Gg, Gg, Gg, Gg, Gg
Gg, Gg, Gg, Gg, Gg, Gg, Co, Gd, Gd, Co, Rb, Gd, Gd, Gd, Rd, Co, Re, Gd, Gd, Co, Gs, Gs, Gs, Gs, Co, Re, Re, Rd, Rb, Co, Co, Gg, Gg, Gg, Gg, Gg
Gg, Gg, Gg, Gs, Gg, Gg, Gd, Re, Re, Re, Gd, Co, Gd, Gd^Vo, Re, Rb, Re, Rd, Rd, Gd, Gd, Gd, Gd^Vo, Gd, Co, Co, Rb, Re, Rb, Co, Gg, Gg, Gg, Gg, Gg, Gg
Gg, Gg, Gg, Gg, Gg, Ko, Co, Re, Re, Re, Re, Co, Co, Re, Re, Co, Rb, Re, Rd, Gd, Ko, Rd, Gd, Gd, Ko, Co, Rb, Re, Co, Co, Ko, Gg, Gg, Gg, Gg, Gg
Gg, Gd^Vo, Gg, Gg, Gg, Gg, Co, Gd, Co, Co, Rb, Co, Rp, Rp, Rb, Re, Rb, Co, Re, Re, Re, Rd, Rd, Co, Co, Co, Re, Re, Re, Co, Gg, Gg, Gg, Gg, Gg, Gg
Gg, Gg, Gg, Gg, Gg, Gg, Co, Gd, Gd^Vo, Co, Re, Rp, Co, Ko, Co, Co, Co, Rb, Re, Rb, Rb, Re, Ko, Co, Re, Re, Rd, Re, Rd, Co, Gs, Gg, Gg, Gd^Vo, Gg, Gg
Gg, Gg, Gg, Gg, Gg, Co, Ko, Rd, Rd, Co, Rp, Rp, Re, Rb, Co, Gd^Vo, Ko, Rb, Re, Co, Rb, Re, Rb, Re, Rd, Rd, Rd, Gd, Gd, Gs, Gs, Gg, Gg, Gg, Gg, Gg
Gg, Gg, Gg, Gg, Gg, Gg, Gg, Gd, Co, Rp, Rb, Re, Re, Re, Rb, Gd, Gs, Rb, Re, Rb, Re, Rb, Re, Re, Re, Re, Gd^Vo, Gd, Co, Co, Co, Gs, Gg, Gg, Gg, Gg
Gg, Gg, Gg, Gg, Gg, Gg, Gg, Gg, Co, Rb, Rb, Rb, Rd, Re, Rd, Gd, Rd, Gd, Rd, Re, Rd, Re, Rb, Rb, Co, Co, Co, Co, Gg, Co, Gg, Gg, Gg, Gg, Gg, Gg
Gg, Gg, Gg, Gg, Gd^Vo, Gg, Gg, Co, Co, Co, Co, Co, Gd, Rb, Rb, Rd, Rb, Rd, Rb, Re, Rd, Rb, Ko, Co, Gg, Co, Gg, Gg, Gg, Gg, Gg, Gg, Gg, Gg, Gg, Gg
Gg, Gg, Gg, Gg, Gg, Gg, Gg, Gg, Gg, Gg, Gg, Gg, Gg, Co, Co, Co, Co, Co, Co, Rb, Gd, Gd, Gg, Gg, Gg, Gg, Gg, Gg, Gg, Gg, Gg, Gg, Gg, Gg, Gg, Gg
