Xom, Xom, Xom, Xom, Xom, Xom, Xom, Xom, Xom, Xom, Xom, Xom, Xom, Xom, Xom, Xom, Xom, Xom, Xom, Xom, Xom, Xom, Xom, Xom, Xom, Xom, Xom, Xom, Xom, Xom, Xom, Xom, Xom, Xom, Xom, Xom, Xom, Xom, Xom, Xom, Xom, Xom, Xom, Xom, Xom, Xom, Xom, Xom
Xom, Xom, Xom, Xom, Xom, Xom, Xom, Xom, Xom, Xom, Xom, Xom, Xuc, Xom, Xom, Xom, Xuc, Xom, Xuc, Xom, Xom, Xom, Xom, Xom, Xuc, Xuc, Xom, Xom, Xuc, Xom, Xom, Xom, Xom, Xom, Xom, Xom, Xuc, Xom, Xom, Xom, Xom, Xom, Xom, Xom, Xom, Xom, Xom, Xom
Xom, Xom, Xom, Xom, Xom, Xom, Xuc, Xom, Xom, Xom, Xuc, Xuc, Xuc, Xom, Xom, Xom, Xuc, Xuc, Xom, Xom, Xuc, Xuc, Xuc, Xuc, Uu, Xuc, Xom, Xom, Uu, Xom, Xuc, Xuc, Xuc, Xom, Xom, Xom, Xuc, Xuc, Uu, Xuc, Xom, Xuc, Xuc, Xuc, Xom, Xom, Xom, Xom
Xom, Xom, Xom, Xom, Xom, Uu, Uu, Uu, Ur, Xom, Ur, Uu, Uu, Uu, Uu, Uu, Uu, Uu, Uu, Uu, Uu, Uu, Uu, Uu^Dr, Uu, Uu, Rr^Esd, Uu, Xom, Xom, Uu, Uu, Uu, Xom, Uu, Uu, Uu, Uu, Uu, Uu, Uu, Uu, Uu^Dr, Uu, Xuc, Xom, Xom, Xom
Xom, Xom, Xom, Xom, Uu, Ur, Rr, Uu, Ur, Ur, Uu, Rr, Rr, Rr, Ur, Ur, Rr, Rr, Ur, Uu, Rr, Rr, Ur, Ur, Uu, Rr^Esd, Uu, Uu, Xom, Uu, Uu, Uu, Rr, Uu, Rr, Uu, Rr, Uu, Uu, Uu, Uu, Uu, Uu, Uu, Xu, Xom, Xom, Xom
Xom, Xom, Xom, Xom, Xom, Uu, Rr, Ur, Ur, Uu, Uu, Uu, Ur, Uu, Uu, Uu, Uu, Rr, Uu, Uu, Uu, Uu, Xuc, Xom, Xuc, Uu, Xom, Rr^Pr/, Uu, Uu, Rr, Uu, Uu, Rr, Uu, Rr, Uu, Uu, Uu, Uu, Uu, Uu^Ebn, Uu, Uu^Dr, Xu, Xom, Xom, Xom
Xom, Xom, Xom, Xom, Xuc, Uu, Uu, Rr, Uu, Ur, Ur, Rr, Uu, Ur, Ur^Dr, Uu, Uu, Xom, Xom, Xom, Xom, Xuc, Uu, Uu, Rr, Xom, Xom, Uu, Uu, Uu^Dr, Uu^Dr, Uu, Uu, Uu, Uu, Uu, Uu^Dr, Rr, Rr, Uu, Uu, Uu, Uu, Uu^Dr, Xuc, Xom, Xom, Xom
Xom, Xom, Xom, Xom, Xom, Xuc, Xom, Ur, Ur, Ur, Uu, Ur, Ur, Rr, Rr, Rr, Rr, Rr, Uu, Uu, Uu, Ur, Ur, Rr, Xom, Xom, Xom, Xuc, Xuc, Uu, Xom, Uu, Uu, Uu, Xuc, Uu, Uu, Uu, Uu, Rr, Rr, Uu, Uu, Uu, Xuc, Xom, Xom, Xom
Xom, Xom, Xom, Xuc, Xuc, Uu, Uu, Xom, Xuc, Xuc, Xom, Uu, Xuc, Uu, Uu, Rr, Uu, Ur, Uu, Ur, Xuc, Rr, Xom, Rr^Pr/, Rr, Rr, Xuc, Xuc, Uu^Es, Xom, Xuc, Xom, Xuc, Xuc, Xuc, Xuc, Xom, Uu, Uu, Uu, Uu, Uu, Uu, Xu, Xom, Xom, Xom, Xom
Xom, Xom, Xuc, Xu, Uu, Uu, Uu, Uu, Xuc, Xom, Uu, Xom, Xuc, Xuc, Xom, Uu, Xuc, Uu, Uu^Dr, Xuc, Xom, Xom, Xuc, Rr, Rr^Es, Uu^Es, Uu^Es, Uu, Uu, Uu, Xuc, Uu, Uu, Uu, Uu, Xuc, Uu, Xom, Uu, Uu, Rr, Uu, Uu, Xu, Xom, Xom, Xom, Xom
Xom, Xom, Xuc, Xu, Xu, Rb, Xuc, Xuc, Xuc, Uu, Rb, Xuc, Uu, Xuc, Uu, Xom, Xom, Xom, Xom, Xom, Xom, Xuc, Xuc, Rr, Uu, Rr^Es, Uu, Uu, Uu^Es, Uu, Xuc, Xuc, Uu, Uu^Dr, Uu, Uu, Uu, Uu, Uu, Uu, Rr, Uu, Uu, Xuc, Xom, Xom, Xom, Xom
Xom, Xom, Xom, Xom, Xu, Rb, Rr, Xuc, Uu, Rb^Trwb, Xu, Xu, Xu, Uu, Uu, Uu, Rb, Xom, Rb, Xom, Xom, Xom, Uu, Uu, Uu^Es, Rr, Uu, Uu, Uu, Uu, Xom, Xom, Uu^Dr, Uu, Uu, Uu, Uu, Uu^Dr, Uu, Uu, Uu, Uu, Uue, Xuc, Xu, Xom, Xom, Xu
Xom, Xom, Xom, Xom, Xuc, Uu, Rb, Xu, Rr, Rb, Xuc, Xuc, Rb^Trwb, Uu, Rb^Trwb, Rb^Trwb, Xu, Xu, Uu, Rb, Xom, Xom, Xom, Uu, Uu, Ur, Ur^Es, Uu, Uu, Xom, Xom, Xom, Xuc, Uu, Uu, Rr, Uu, Uu, Uu, Rr, Uu, Uu, Uu^Dr, Uu^Dr, Xu, Xom, Xu, Xu
Xom, Xom, Xom, Xuc, Xuc, Rb, Rr, Xu, Rr^Pw/, Xuc, Xuc, Rr, Rb^Trwb, Uu, Xuc, Xuc, Uu, Rb, Xuc, Xuc, Xom, Xom, Xom, Xom, Uu, Uu^Es, Rr, Ur, Uu, Xuc, Xom, Xom, Uu, Uu, Uu, Rr, Uu, Uu, Uu, Uu, Uu, Uu^Dr, Xuc, Xuc, Xu, Xom, Xu, Xu
Xom, Xom, Xom, Xuc, Xuc, Uu, Rr, Xuc, Rr, Rr, Rr, Rr^Pw\, Xuc, Xuc, Rb, Uu, Rr, Rr, Xuc, Rb, Xom, Xom, Xom, Xuc, Uu^Es, Ur^Es, Rr, Uu^Es, Uu, Xuc, Xom, Xuc, Uu, Uu^Dr, Uu, Uu, Rr, Rr, Uu, Uu, Xuc, Xuc, Xu, Xuc, Xu, Xom, Xom, Xu
Xom, Xom, Xom, Xom, Xuc, Uu, Rr^Pw/, Xuc, Ur, Uu^Es, Rr, Uu, Xuc, Rb, Rr, Rr, Rr, Xu, Rb^Trwb, Uu, Xom, Xom, Xom, Xom, Uu, Ur, Rr, Uu^Es, Xom, Xom, Xom, Xuc, Uu, Uu^Dr, Uu, Uu, Uu, Uu, Xuc, Xuc, Xu, Xu, Uu^Em, Uu^Dr, Xu, Xom, Xu, Xu
Xom, Xom, Xom, Xom, Xuc, Xom, Rr, Rr, Ur^Es, Rr^Es, Rr^Es, Ur, Uu, Rr^Pw\, Xuc, Rr, Xu, Xu, Uu, Uu, Xom, Xom, Xuc, Uu^Trwb, Uu^Es, Rr, Uu, Uu, Uu, Xuc, Xom, Xom, Uu, Uu^Dr, Uu, Uu, Rr, Uu, Xuc, Xu, Rr^Dr, Uue^Em, Uu, Uu^Dr, Xu, Xu, Rb^Es, Rb^Es
Xom, Xom, Xom, Xom, Rr, Xuc^Trwb, Xuc, Rr, Rr^Es, Uu^Es, Ur, Ur^Es, Uu, Rr, Uu, Xuc, Xuc, Rr, Rb^Edb, Rb, Xom, Xom, Xom, Uu, Uu, Ur, Uu^Es, Ur, Uu, Xuc, Xom, Xom, Xuc, Uu, Uu^Dr, Uu, Rr, Xuc, Xuc, Xu, Uu^Em, Uu, Uu^Em, Rb^Em, Rb, Xu, Uue^Em, Uue^Emf
Xom, Xom, Xom, Xom, Rr, Rr, Uu, Rr^Pw\, Xuc, Uu, Uu, Ur, Uu^Es, Ur^Es, Ur^Es, Ur, Uu^Es, Xuc, Rr^Pw\, Rr, Rr, Xom, Xom, Uu, Uu, Rr^Es, Rr^Es, Ur, Uu, Uu^Es, Uu^Es, Xom, Xom, Uu, Uu, Uu, Rr, Uu^Dr, Xuc, Xu, Uue, Uue, Uu^Em, Uu^Uf, Xu, Re, Re^Em, Ww
Xom, Xom, Xom, Xom, Uu^Trwb, Rb, Uu, Rr, Xuc, Xuc, Rr^Pw\, Uu, Ur, Rr, Rr^Es, Uu, Uu, Rr, Rr, Xuc^Trwb, Xuc, Xom, Xom, Xom, Uu, Ur, Ur^Es, Rr, Uu, Uu, Uu, Xom, Xuc, Xuc, Uu, Uu, Rr, Uu^Dr, Xuc, Xu, Xu, Xu, Rb^Em, Uue, Uue^Em, Re^Em, Ww^Es, Ww
Xom, Xom, Xom, Xom, Rb, Rb, Xu, Xuc, Uu, Rb, Xom, Xuc, Rr^Pw\, Rr, Rr, Rr, Ur, Rr^Es, Rr^Es, Rr, Rr, Xom, Xuc, Xuc, Uu, Uu, Uu, Rr, Uu, Uu^Eb, Uu, Xuc, Xom, Xom, Xuc, Uu, Uu^Em, Uu^Em, Xuc, Xu, Rb, Rb^Em, Uue, Rb^Em, Uue^Emf, Wwrt, Uue^Em, Uue^Em
Xom, Xom, Xom, Xom, Xu, Xu, Uu, Uu, Xuc, Xuc, Uu^Edb, Rr^Edb, Rb^Edb, Xuc, Xu, Rr^Es, Rr, Ur, Ur, Rr^Es, Rr, Rr, Uu, Xom, Ur, Uu, Rr^Es, Ur, Ur^Es, Uu^Es, Uu, Xom, Xom, Xom, Xuc, Uu, Uu, Uu^Em, Uue, Re, Uue, Uue, Uue^Emf, Re^Em, Ww, Ww^Es, Re^Em, Xu
Xom, Xom, Xom, Xuc, Uu, Uu, Uu, Xuc, Rb, Uu^Edt, Rb^Edt, Rb^Edt, Rr^Pr/, Xu, Uu, Xuc, Rr^Pw\, Rr^Es, Uu, Rr, Rr^Es, Ur, Xom, Ur, Ur, Ur^Es, Uu, Uu^Es, Uu, Uu, Xuc, Xom, Xom, Xom, Uu, Rr, Uue, Uue^Em, Uu^Uf, Rb, Rb, Rb^Em, Re^Em, Ww, Ww^Es, Uue, Xu, Xu
Xom, Xom, Xom, Xuc, Rr, Uu, Rr, Xuc, Rr, Uu, Xu, Xu, Rr, Rb, Uu, Uu, Rr, Xuc, Xuc, Uu^Es, Rr, Rr, Xuc, Xuc, Xuc, Uu, Uu, Uu, Xuc, Xuc, Xom, Xom, Xom, Xom, Uu, Uu, Uu, Rb^Em, Re^Em, Uue^Em, Rb^Em, Uue^Em, Ww, Ww^Es, Uue^Em, Re^Em, Rb, Xu
Xom, Xom, Xom, Xu, Xom, Rr, Xu, Xom, Xom, Xu, Xu, Rr, Xuc, Rr, Xu, Rr, Xu, Rr, Rb, Xom, Xuc, Xuc, Xom, Xom, Xom, Xom, Xom, Xom, Xom, Xom, Rr, Uu, Rr, Uu, Uu, Uue, Rb^Emf, Xuc, Uue^Em, Re^Em, Uue^Em, Ww, Re^Em, Re^Em, Uue^Emf, Xu, Rb^Dr, Xu
Xom, Xom, Xom, Xom, Xom, Xom, Xom, Xom, Xom, Xom, Xom, Xuc, Xom, Xom, Xom, Xom, Xom, Xu, Xu, Xu, Xom, Xom, Xom, Xom, Xom, Xom, Xom, Xom, Xom, Rr, Uu, Uu^Ebn, Uu, Rr, Xuc, Xuc, Xuc, Xuc, Re^Em, Rb^Em, Rb^Em, Ww, Uue^Em, Rb^Em, Xu, Xu, Xom, Xu
Xom, Xom, Xom, Xom, Xom, Xom, Xom, Xom, Xom, Xom, Xom, Xom, Xom, Xom, Xom, Xom, Xom, Xom, Xom, Xom, Xom, Xom, Xom, Xom, Rr, Rr, Rr, Rr, Rr, Rr^Pr\, Xuc, Uu, Xuc, Uu^Dr, Xom, Xom, Xom, Xu, Rb^Em, Uue^Emf, Re^Em, Ww^Es, Ww^Es, Uue^Emf, Rb^Em, Xu, Xu, Xom
Xom, Xom, Xom, Xom, Xom, Xom, Xom, Xom, Xom, Xom, Xom, Xom, Xom, Xom, Xom, Xom, Xom, Xom, Xom, Xom, Rr, Rr, Rr, Rr, Rr, Rr, Rr, Rr, Rr, Rr, Xom, Xom, Xom, Xuc, Xom, Xom, Xom, Xu, Rb^Dr, Re^Em, Uue^Emf, Wwrt, Ww^Es, Uue^Em, Rb^Em, Xu, Xu, Xom
Xom, Xom, Xom, Xom, Xom, Xom, Xom, Xom, Xom, Xom, Xom, Xom, Xom, Xom, Xom, Xom, Xom, Xom, Xom, Xom, Rr, Rr, Rr, Rr, Rr, Rr, Rr, Rr, Xom, Xom, Xom, Xom, Xom, Xom, Xom, Xom, Xom, Xu, Xu, Rb, Uue, Uue^Emf, Uue, Ww, Ww, Rb, Uue, Xu
