Ms, Ms, Ms, Ms, Ms, Ms, Ai, Ms, Ms, Ms, Ha, Wo, Wo, Ms, Ms, Ms, Ms, Ms, Ms^Xm, Ms, Ms, Ai, Wo, Wo, Wo, Wo, Wo, Wo, Wo, Wo, Wo, Wo, Mm, Wo, Mm, Mm, Mm, Mm, Mm, Mm, Mm, Mm, Gs^Fms, Gs^Fms, Mm, Mm, Mm, Mm
Ms, Ms, Ms, Ms, Wo, Ai, Ha, Wo, Wo, Wo, Wo, Wo, Ms, Ms, Ms, Ms, Ms^Xm, Ms^Xm, Ms^Xm, Ms, Ms, Ms, Wo, Wo, Wo, Wo, Wo, Wo, Wo, Wo, Mm^Xm, Mm^Xm, Mm, Mm, Mm, Mm, Mm, Mm, Mm, Mm, Mm, Mm, Gg, Gg, Ww, Mm, Mm, Mm
Ms, Ms, Ha, Wo, Ms, Mm^Xm, Mm^Xm, Wo, Wo, Wo, Ms, Ms, Ms, Ms, Ms, Ms, Ms^Xm, Ms, Ms, Ms, Ms, Ha, Ww, Wo, Wo, Wo, Wo, Wo, Wo, Mm^Xm, Mm^Xm, Mm^Xm, Mm^Xm, Mm, Mm, Mm, Mm, Mm, Mm, Mm, Mm, Ww, Ww, Ww, Md, Ww, Ww, Mm
Ha, Ha, Ai, Ai, Aa^Fma, Ms, Ms, Mm^Xm, Ms, Ms, Ms, Ms, Ms^Xm, Ms^Xm, Ms^Xm, Ms^Xm, Ms, Ms, Ms, Ms, Ms, Ha, Ww, Wo, Wo, Wo, Wo, Wo, Gs^Fms, Mm, Mm, Mm^Xm, Mm^Xm, Mm, Mm, Mm, Mm, Mm, Mm, Mm, Ww, Ww, Md, Md, Md, Md, Md, Ww
Wo, Ai, Aa, Rb, Rb, Aa^Fma, Aa, Ms, Ms, Ms, Ms^Xm, Ms, Ms^Xm, Ms^Xm, Ms^Xm, Ms^Xm, Ms, Ms, Ms, Ms, Wwr, Ww, Wwt, Wwt, Wwt, Wwt, Wwt, Wwt, Wwr, Gs^Fms, Mm, Mm^Xm, Mm, Mm, Mm, Mm, Mm, Mm, Wo, Wo, Ww, Ww, Wo, Md, Md, Md, Md, Md
Wo, Ai, Ms, Ha, Aa, Aa, Aa, Aa, Ms, Ms, Ms, Ms^Xm, Ms, Ms^Xm, Ms^Xm, Ms, Ms, Ms, Ms, Ha, Ha, Wwt, Wwt, Wwt, Aa, Ww, Aa, Mm, Mm, Ww, Wwt, Mm, Mm, Mm, Ww, Wo, Ww, Mm, Ww, Ww, Mm, Ww, Ww, Wo, Hh, Md, Md, Md
Wo, Ai, Ms, Ms, Aa, Rb, Ha, Ha, Ms, Ms, Ms, Ms, Ms, Ms, Ms^Xm, Ms, Ms, Ms, Ms, Hh^Vhh, Ms, Ha, Ms, Mm, Aa^Fma, Aa, Mm, Mm, Mm, Mm, Mm, Ww, Ww, Ww, Ww, Ww, Ww, Mm, Wwr, Mm, Mm, Mm, Mm, Ww, Ww, Hh, Hh, Md
Mm, Ms, Ha, Ms, Aa, Rb, Ha, Ha, Ms, Ms, Ms, Ms, Ms, Ms, Ms, Ms^Xm, Ms, Ms, Aa, Ms, Ms, Ms, Ms, Mm, Mm, Mm, Mm, Mm, Mm, Mm, Mm, Mm, Mm, Mm, Mm, Ww, Ww, Wwr, Mm, Mm, Mm, Mm, Mm, Mm, Wo, Ww, Ww, Ww
Mm, Ms, Ms, Ha, Ms, Aa, Aa, Aa, Aa, Ms, Ha, Ms, Ms, Ms, Ms, Ms^Xm, Ms, Ms, Ms, Ms, Ms, Ms, Ms, Mm, Mm, Mm, Mm, Mm, Mm, Mm, Mm, Mm, Mm, Mm, Mm, Mm, Mm, Mm, Mm, Mm, Mm, Mm, Mm, Mm, Mm, Wo, Mm, Mm
Mm, Mm, Mm, Ms, Ha, Ha, Aa, Rb, Aa, Aa, Ha, Ha, Ms, Ms, Ms, Ms^Xm, Ms, Ms, Ms, Ms, Ms, Ms, Ms, Mm, Mm, Mm, Mm, Mm, Mm, Mm, Mm, Mm, Mm, Mm, Mm, Mm, Mm, Mm, Mm, Mm, Mm, Mm, Mm, Mm, Mm, Mm, Mm, Mm
Mm, Mm, Mm, Ms, Ha, Ms, Aa, Rb, Rb, Rb^Eb, Ha, Ha, Ha, Ms, Ms, Ms, Ms, Ms, Ms, Ms, Ms, Ms, Ms, Mm, Mm, Mm, Mm, Mm, Mm, Mm, Mm, Mm, Mm, Mm, Mm, Mm, Mm, Mm, Mm, Mm, Mm, Mm, Mm, Mm, Mm, Mm, Mm, Mm
Mm, Mm, Mm, Ms, Ms, Ha, Ha, Rb, Rb, Ha, Ms, Ms, Ms, Ha, Ms, Ms, Ms, Ms, Ms, Ms, Ms, Ms, Ms, Mm, Mm, Mm, Mm, Mm, Mm, Mm, Mm, Mm, Mm, Mm, Mm, Mm, Mm, Mm, Mm, Mm, Mm, Mm, Mm, Mm, Mm, Mm, Mm, Mm
Mm, Mm, Mm, Mm, Ms, Ha, Ms, Aa, Rb, Aa, Aa, Ms, Ha, Ha, Ms, Ms, Ms, Ms, Ms, Ms, Ms, Mm, Mm, Mm, Mm, Mm, Mm, Mm, Mm, Mm, Mm, Mm, Mm, Mm, Mm, Mm, Mm, Mm, Mm, Mm, Mm, Mm, Mm, Mm, Mm, Mm, Mm, Mm
Mm, Mm, Mm, Mm, Ms, Ms^Xm, Ms, Aa, Aa, Rb, Aa, Ms, Ha, Ms, Ms^Xm, Ms, Ms, Ms, Ms, Ms, Ms, Mm, Mm, Mm, Mm, Mm, Mm, Mm, Mm, Mm, Mm, Mm, Mm, Mm, Mm, Mm, Mm, Mm, Mm, Mm, Mm, Mm, Mm, Mm, Mm, Mm, Mm, Mm
Mm, Mm, Mm, Mm, Ms, Ms, Ms, Ms, Aa, Rb, Ha, Ha, Ms^Xm, Ms, Ms, Ms, Ms, Ms, Ms, Ms, Mm, Mm, Mm, Mm, Mm, Mm, Mm, Mm, Mm, Mm, Mm, Mm, Mm, Mm, Mm, Mm, Mm, Mm, Mm, Mm, Mm, Mm, Mm, Mm, Mm, Mm, Mm, Mm
Mm, Mm, Mm, Mm, Ms, Ms^Xm, Ms, Ms, Aa, Rb, Ms, Ms, Ms, Ms, Ms, Ms, Ms^Xm, Ms, Ms, Mm, Mm, Mm, Mm, Mm, Mm, Mm, Mm, Mm, Mm, Mm, Mm, Mm, Mm, Mm, Mm, Mm, Mm, Mm, Mm, Mm, Mm, Mm, Mm, Mm, Mm, Mm, Mm, Mm
Mm, Mm, Mm, Mm, Ms, Ms, Ms, Ms, Ha, Aa, Aa, Aa, Ms, Ms, Aa, Ms, Ms, Ms, Ms, Mm, Mm, Mm, Mm, Mm, Mm, Mm, Mm, Mm, Mm, Mm, Mm, Mm, Mm, Mm, Mm, Mm, Mm, Mm, Mm, Mm, Mm, Mm, Mm, Mm, Mm, Mm, Mm, Mm
Mm, Mm, Mm, Ms, Ms, Ms, Ms, Ms, Ha, Ms, Rb, Ms, Aa, Aa, Ha, Aa, Aa, Ms, Ms, Mm, Mm, Mm, Mm, Mm, Mm, Mm, Mm, Mm, Mm, Mm, Mm, Mm, Mm, Mm, Mm, Mm, Mm, Mm, Mm, Mm, Mm, Mm, Mm, Mm, Mm, Mm, Mm, Mm
Mm, Mm, Ms, Ms, Ms, Ms, Ha, Ha, Aa, Ms, Ha^Vhha, Rb, Ha, Ha, Ha^Vhha, Ha, Rb, Ha, Aa, Ms, Ms, Mm, Mm, Mm, Mm, Mm, Mm, Mm, Mm, Mm, Mm, Mm, Mm, Mm, Mm, Mm, Mm, Mm, Mm, Mm, Mm, Mm, Mm, Mm, Mm, Mm, Mm, Mm
Mm, Ms, Ms, Ms, Ms, Ha, Ha, Ha, Aa, Ha, Ha, Rb, Kha, Ha, Ha, Ha, Rb, Aa, Rb, Aa, Ms, Mm, Mm, Mm, Mm, Mm, Mm, Mm, Mm, Mm, Mm, Mm, Mm, Mm, Mm, Mm, Mm, Mm, Mm, Mm, Mm, Mm, Mm, Mm, Mm, Mm, Mm, Mm
Ms, Ms, Ms^Xm, Ms, Ms, Ms, Ha, Aa, Aa, Ha, Cha, Rb, Rrc^Vhca, Rrc, Ha, Cha, Ha, Rb, Aa, Rb, Mm, Mm, Mm, Mm, Mm, Mm, Mm, Mm, Mm, Mm, Mm, Mm, Mm, Mm, Mm, Mm, Mm, Mm, Mm, Mm, Mm, Mm, Mm, Mm, Mm, Mm, Mm, Mm
Ms, Ms, Ms^Xm, Ms, Ms, Ms, Ha, Aa, Ha, Aa, Cha, Rrc, Rrc, Cha, Cha, Cha, Ha, Ms, Ms, Ms, Ms, Mm, Mm, Mm, Mm, Mm, Mm, Mm, Mm, Mm, Mm, Mm, Mm, Mm, Mm, Mm, Mm, Mm, Mm, Mm, Mm, Mm, Mm, Mm, Mm, Mm, Mm, Mm
Ms^Xm, Ms^Xm, Ms, Ms, Ms, Ms, Ms, Ms, Ms, Ha, Rb, Cha, Rrc, Kha, Aa, Cha, Aa, Ha^Vhha, Ms, Ms, Aa, Mm, Mm, Mm, Mm, Mm, Mm, Mm, Mm, Mm, Mm, Mm, Mm, Mm, Mm, Mm, Mm, Mm, Mm, Mm, Mm, Mm, Mm, Mm, Mm, Mm, Mm, Mm
Ms, Ms, Ms, Ms, Ms, Ms, Ms, Ha, Ha, Ha^Vhha, Rb, Cha, Cha, Rrc, Cha, Cha, Cha, Aa, Ha, Aa, Ms, Mm, Mm, Mm, Mm, Mm, Mm, Mm, Mm, Mm, Mm, Mm, Mm, Mm, Mm, Mm, Mm, Mm, Mm, Mm, Mm, Mm, Mm, Mm, Mm, Mm, Mm, Mm
Ms, Ms^Xm, Ms, Ms^Xm, Ms, Ha, Ha, Aa, Rb, Ha, Rb, Ha, Ha, Cha, Ha, Ha, Ha, Ha, Ha, Ms, Ms, Mm, Mm, Mm, Mm, Mm, Mm, Mm, Mm, Mm, Mm, Mm, Mm, Mm, Mm, Mm, Mm, Mm, Mm, Mm, Mm, Mm, Mm, Mm, Mm, Mm, Mm, Mm
Ms, Ms, Ms, Ms, Ms, Ha, Ha, Rb, Rb, Aa, Ha, Ms, Ha, Cha, Ha, Ha^Vhha, Ha, Ms, Rb, Ms, Ms, Mm, Mm, Mm, Mm, Mm, Mm, Mm, Mm, Mm, Mm, Mm, Mm, Mm, Mm, Mm, Mm, Mm, Mm, Mm, Mm, Mm, Mm, Mm, Xu, Xu, Xu, Mm
Ms, Ms, Ms^Xm, Ms, Ms, Ha, Ha, Ha, Rb, Aa, Ha, Ms, Ms, Rb, Rb, Rb, Aa, Ms, Aa, Rb, Mm, Mm, Mm, Mm, Mm, Mm, Mm, Mm, Mm, Mm, Mm, Mm, Mm, Mm, Mm, Mm, Mm, Mm, Mm, Mm, Mm, Mm, Mm, Xu, Xu, Xu, Xu, Xu
Ms^Xm, Ms, Ms, Ms, Ms, Ha, Rb, Ha, Mm, Ha, Aa, Ms, Ms, Aa, Ha, Rb, Ms, Ms, Ha, Rb, Mm, Mm, Mm, Mm, Mm, Mm, Mm, Mm, Mm, Mm, Mm, Mm, Mm, Mm, Mm, Mm, Mm, Mm, Mm, Mm, Mm, Mm, Mm, Xu, Xu, Xu, Xu, Xu
Ms, Ms, Ms, Ms, Rb, Rb, Ha, Mm, Mm, Mm, Mm, Ha, Mm, Ha, Mm, Mm, Mm, Ms, Mm, Mm, Mm, Mm, Mm, Mm, Mm, Mm, Mm, Mm, Mm, Mm, Mm, Mm, Mm, Mm, Mm, Mm, Mm, Mm, Mm, Mm, Mm, Mm, Xu, Xu, Xu, Xu, Xu, Xu
