Xos, Xos, Xos, Xos, Xos, Xos, Xos, Xos, Xos, Xos, Xos, Xos, Xos, Xos, Xos, Xos, Xos, Xos, Xos, Xu, Xu, Xu, Xu, Xu, Xu, Xu, Xu, Xu, Xu, Xu, Xu, Xu, Xu, Xu, Xu, Xu, Xu, Xu, Xu, Xu, Xu, Xu, Xu, Xu, Xu, Xu, Xu, Wo, Xu, Xu, Xu, Uu, Xu, Xu
Xos, Xos, Xos, Xos, Xos, Xos, Xos, Xos, Xos, Xos, Xos, Xos, Uu, Xos, Uu, Xos, Xos, Xos, Xos, Xos, Xos, Xu, Xos, Xu, Xu, Xu, Xu, Xu, Uu, Xu, Uu, Xu, Xu, Xu, Xu, Xu, Xu, Xu, Xu, Xu, Xu, Xu, Xu, Xu, Xu, Xu, Wog, Wog, Xu, Xu, Uu, Xu, Xu, Xu
Xos, Xos, Uu, Uu, Uu, Xos, Xos, Xos, Xos, Xos, Xos, Uu, Uu, Uu, Uu, Uu, Uu, Xos, Uu, Xos, Uu, Xos, Uu, Xu, Uu, Uu, Ur, Uu, Ur, Uu, Ur, Uu, Uu, Uu, Uu, Xu, Uu, Xu, Uu, Xu, Uu, Uu, Uu, Xu, Uu, Uu, Wog, Rb, Uu, Uu, Rb, Xu, Xu, Xu
Xos, Xos, Uu, Uu, Uu, Uu, Uu, Uu, Uu, Xos, Uu, Uu, Urb, Urb, Urb, Urb, Uu, Uu, Uu, Uu, Uu, Ur, Uu, Uu, Ur, Uu, Uu, Uu, Urb, Ur, Ur, Ur, Ur, Uu, Uu, Uu, Uu, Uu, Xu, Xu, Uu, Uu, Re, Re, Uu, Uu, Wog, Rb, Uu, Re, Re, Xu, Xu, Xu
Xos, Xos, Uu, Uu, Urb, Urb, Urb, Uu, Uu, Uu, Ur, Urb, Urb, Uu, Urb, Urb, Uu, Ur, Uu, Urb, Rb, Ur, Ur, Uu, Rb, Ur, Ur, Ur, Uu, Ur, Uu, Uu, Uu, Uu, Uu, Uu, Uu, Uu, Xu, Uu, Rb, Re, Uu, Re, Re, Uu, Sm, Rb, Uu, Rb, Uu, Xu, Xu, Xu
Xos, Xos, Uu, Uu, Urb, Uu, Uu, Urb, Uu, Uu, Urb, Urb, Uu, Urb, Urb, Urb, Uu, Uu, Uu, Rb, Rb, Ur, Rb, Ur, Ur, Ur, Uu, Uu, Uu, Xu, Xu, Uu, Uu, Uu, Ur, Ur, Uu, Xu, Xu, Uu, Uu, Rb, Uu, Re, Uu, Uu, Sm, Rb, Uu, Re, Uu, Xu, Xu, Xu
Xos, Xos, Uu, Uu, Uu, Urb, Urb, Ur, Ur, Uu, Ur, Urb, Urb, Uu, Ur, Uu, Urb, Urb, Urb, Urb, Uu, Ur, Uu, Uu, Uu, Uu, Uu, Uu, Xu, Xu, Xu, Xu, Uu, Uu, Uu, Ur, Uu, Xu, Xu, Uu, Uu, Rb, Rb, Re, Uu, Rb, Sm, Sm, Rb, Uu, Xu, Xu, Xu, Xu
Xos, Xos, Uu, Uu, Uu, Uu, Urb, Uu, Urb, Uu, Uu, Uu, Uu, Uu, Uu, Uu, Uu, Uu, Uu, Uu, Uu, Uu, Uu, Uu, Xu, Uu, Xu, Xu, Xu, Xu, Xu, Xu, Uu, Ur, Uu, Uu, Ur, Uu, Xu, Xu, Uu, Uu, Rb, Uu, Uu, Rb, Sm, Sm, Rb, Uu, Xu, Xu, Xu, Xu
Xos, Xos, Xos, Uu, Uu, Urb, Urb, Uu, Uu, Uu, Xos, Uu, Uu, Uu, Uu, Uu, Uu, Uu, Uu, Uu, Xos, Xos, Xos, Xos, Xos, Xu, Xu, Xu, Xu, Xu, Uu, Uu, Uu, Uu, Uu, Ur, Uu, Uu, Uu, Xu, Xu, Uu, Uu, Re, Uu, Rb, Sm, Ww, Ww, Rb, Rb, Xu, Xu, Xu
Xos, Xos, Xos, Uu, Uu, Uu, Ur, Uu, Xos, Xos, Uu, Xos, Xos, Xos, Uu, Uu, Xos, Uu, Xos, Xos, Xos, Xos, Uu, Uu, Uu, Xos, Xos, Xu, Uu, Uu, Uu, Uu, Uu, Ur, Ur, Uu, Xu, Uu, Uu, Xu, Xu, Xu, Uu, Rb, Uu, Rb, Wwt, Ww, Ww, Sm, Sm, Xu, Xu, Xu
Xos, Xos, Xos, Uu, Uu, Urb, Ur, Uu, Uu, Xos, Uu, Uu, Uu, Xos, Xos, Xos, Xos, Uu, Xos, Xos, Uu, Uu, Uu, Rb, Uu, Uu, Uu, Xu, Uu, Uu, Uu, Rb, Rb, Uu, Ur, Uu, Uu, Xu, Xu, Xu, Xu, Xu, Xu, Uu, Uu, Uu, Wwt, Ww, Sm, Uu, Uu, Xu, Xu, Xu
Xos, Xos, Xos, Uu, Uu, Uu, Uu, Urb, Urb, Uu, Uu, Uu, Uu, Uu, Uu, Xos, Xos, Xos, Xos, Xos, Uu, Uu, Uu, Uu, Urb, Uu, Uu, Xu, Xu, Uu, Uu, Rb, Ur, Ur, Rb, Uu, Uu, Xu, Xu, Xu, Xu, Xu, Xu, Xu, Uu, Rb, Wwt, Wwr, Uu, Uu, Uu, Xu, Xu, Xu
Xos, Xos, Xos, Uu, Uu, Ur, Urb, Urb, Urb, Urb, Urb, Uu, Urb, Uu, Uu, Uu, Uu, Uu, Uu, Uu, Urb, Uu, Urb, Urb, Urb, Uu, Uu, Uu, Xos, Xu, Uu, Uu, Ur, Uu, Rb, Uu, Uu, Xu, Xu, Xu, Xu, Xu, Uu, Uu, Re, Wwt, Sm, Uu, Rb, Re, Uu, Uu, Xu, Xu
Xos, Xos, Xos, Uu, Uu, Uu, Ur, Uu, Uu, Urb, Urb, Uu, Urb, Urb, Urb, Uu, Urb, Urb, Urb, Urb, Urb, Urb, Rb, Uu, Rb, Rb, Rb, Uu, Xu, Xu, Uu, Rb, Rb, Rb, Ur, Rb, Rb, Uu, Xu, Xu, Xu, Rb, Re, Uu, Ww, Ww, Sm, Uu, Re, Uu, Xu, Xu, Xu, Xu
Xos, Xos, Xos, Xos, Xos, Uu, Uu, Uu, Ur, Uu, Uu, Urb, Uu, Urb, Uu, Uu, Rb, Urb, Rb, Rb, Uu, Urb, Urb, Uu, Uu, Urb, Rb, Uu, Xu, Uu, Uu, Uu, Ur, Uu, Wo, Uu, Uu, Uu, Xu, Xu, Xu, Re, Rb, Ww, Sm, Sm, Uu, Re, Uu, Uu, Xu, Xu, Xu, Xu
Xos, Xos, Xos, Xos, Xos, Uu, Xos, Uu, Xos, Uu, Xos, Uu, Xos, Xos, Xos, Uu, Uu, Rb, Rb, Rb, Uu, Urb, Uu, Uu, Sm, Uu, Uu, Xu, Sm, Sm, Wwt, Sm, Sm, Sm, Ww, Wo, Wo, Uu, Wog, Wo, Wo, Rb, Wwt, Wwt, Sm, Sm, Re, Uu, Xu, Xu, Xu, Xu, Xu, Xu
Xos, Xos, Xos, Xos, Xos, Xos, Urb, Xos, Uu, Xos, Xos, Xos, Xos, Xos, Xos, Uu, Uu, Uu, Xos, Uu, Urb, Urb, Uu, Sm, Sm, Wo, Wo, Wo, Wwt, Wwt, Uu, Uu, Ww, Ww, Sm, Sm, Xu, Wog, Rb, Wo, Wo, Sm, Ww, Ww, Rb, Uu, Re, Uu, Xu, Xu, Xu, Xu, Xu, Xu
Xos, Xos, Xos, Urb, Uu, Urb, Uu, Urb, Uu, Uu, Uu, Uu, Xos, Xos, Xos, Xos, Xos, Xos, Xos, Urb, Urb, Urb, Sm, Sm, Wog, Wo, Sm, Sm, Uu, Uu, Uu, Ww, Ww, Ww, Uu, Xu, Xu, Xu, Xu, Rb, Xu, Wo, Ww, Rb, Uu, Uu, Xu, Xu, Xu, Xu, Xu, Xu, Xu, Xu
Xos, Xos, Xos, Urb, Uu, Uu, Urb, Uu, Urb, Uu, Xos, Xos, Xos, Xos, Xos, Xos, Re, Xos, Re, Urb, Wog, Sm, Wo, Wog, Wo, Wo, Uu, Uu, Uu, Rb, Ur, Uu, Uu, Uu, Xu, Xu, Xu, Xu, Xu, Xu, Xu, Sm, Rb, Ww, Re, Uu, Xu, Xu, Xu, Xu, Xu, Xu, Xu, Xu
Xos, Xos, Xos, Urb, Urb, Uu, Urb, Urb, Urb, Urb, Xos, Xos, Xos, Xos, Uu, Uu, Rb, Rb, Urb, Re, Wog, Wo, Xu, Wo, Sm, Sm, Uu, Rb, Rb, Rb, Rb, Rb, Uu, Xu, Xu, Xu, Xu, Xu, Xu, Xu, Xu, Xu, Ww, Rb, Re, Uu, Rb, Uu, Uu, Uu, Xu, Xu, Xu, Xu
Xos, Xos, Uu, Uu, Urb, Uu, Urb, Urb, Urb, Urb, Urb, Xos, Uu, Uu, Rb, Rb, Urb, Rb, Sm, Wog, Sm, Sm, Xu, Sm, Uu, Uu, Rb, Rb, Ur, Uu, Rb, Ur, Uu, Xu, Xu, Xu, Xu, Xu, Xu, Xu, Xu, Ww, Rb, Rb, Re, Uu, Rb, Uu, Uu, Uu, Uu, Xu, Xu, Xu
Xos, Xos, Xos, Urb, Urb, Urb, Urb, Urb, Urb, Urb, Urb, Rb, Uu, Uu, Rb, Rb, Urb, Sm, Wog, Wog, Sm, Xu, Xu, Uu, Uu, Rb, Rb, Uu, Ur, Uu, Rb, Ur, Uu, Xu, Xu, Xu, Xu, Xu, Xu, Xu, Xu, Xu, Uu, Uu, Uu, Re, Uu, Re, Rb, Uu, Uu, Xu, Xu, Xu
Xos, Xos, Urb, Urb, Urb, Urb, Urb, Urb, Urb, Urb, Urb, Rb, Uu, Rb, Rb, Uu, Xos, Sm, Wog, Sm, Xu, Wwr^Em, Wwr^Em, Xu, Xu, Rb, Uu, Uu, Rb, Ur, Uu, Uu, Uu, Xu, Xu, Xu, Xu, Xu, Xu, Xu, Xu, Xu, Xu, Uu, Xu, Uu, Uu, Uu, Re, Rb, Uu, Xu, Xu, Xu
Xos, Xos, Urb, Urb, Urb, Urb, Urb, Urb, Xos, Uu, Xos, Urb, Xos, Uu, Xos, Xos, Sm, Wog, Sm, Xos, Xos, Xu, Ww^Es, Xu, Xu, Xu, Xu, Uu, Uu, Ur, Ur, Rb, Ur, Uu, Uu, Xu, Xu, Xu, Xu, Xu, Xu, Xu, Xu, Xu, Xu, Xu, Uu, Uu, Uu, Rb, Uu, Xu, Xu, Xu
Xos, Xos, Xos, Urb, Urb, Urb, Urb, Urb, Uu, Xos, Xos, Xos, Xos, Xos, Uu, Sm, Wog, Wog, Sm, Urb, Urb, Xos, Xos, Xu, Rb, Xu, Xu, Xu, Xu, Uu, Uu, Ur, Ur, Uu, Uu, Uu, Uu, Xu, Xu, Xu, Xu, Xu, Xu, Xu, Xu, Xu, Xu, Uu, Rb, Re, Re, Uu, Xu, Xu
Xos, Xos, Xos, Urb, Urb, Urb, Urb, Urb, Uu, Uu, Xos, Xos, Xos, Urb, Uu, Sm, Wog, Ww, Urb, Urb, Urb, Xos, Urb, Uu, Rb, Xu, Xu, Xu, Xu, Uu, Uu, Uu, Uu, Rb, Uu, Uu, Uu, Xu, Xu, Xu, Xu, Xu, Xu, Xu, Xu, Xu, Uu, Rb, Uu, Uu, Uu, Uu, Xu, Xu
Xos, Xos, Xos, Urb, Urb, Urb, Urb, Urb, Uu, Xos, Xos, Uu, Urb, Uu, Rb, Wog, Wog, Ww, Urb, Urb, Uu, Urb, Uu, Uu, Uu, Xu, Xu, Xu, Uu, Uu, Ur, Uu, Uu, Uu, Uu, Uu, Xu, Xu, Xu, Xu, Uu, Xu, Uu, Xu, Uu, Uu, Rb, Re, Uu, Uu, Xu, Xu, Xu, Xu
Xos, Xos, Xos, Urb, Urb, Urb, Urb, Urb, Urb, Xos, Xos, Uu, Rb, Uu, Rb, Rb, Wog, Sm, Urb, Urb, Uu, Urb, Uu, Urb, Xu, Xu, Xu, Xu, Uu, Uu, Uu, Uu, Uu, Uu, Xu, Xu, Xu, Xu, Uu, Uu, Uu, Uu, Re, Uu, Re, Uu, Rb, Re, Rb, Uu, Xu, Xu, Xu, Xu
Xos, Xos, Xos, Xos, Urb, Urb, Urb, Urb, Urb, Urb, Urb, Uu, Uu, Rb, Rb, Rb, Ww, Sm, Urb, Urb, Urb, Uu, Urb, Xu, Xu, Xu, Uu, Uu, Ur, Ur, Uu, Uu, Xu, Xu, Xu, Xu, Xu, Xu, Uu, Uu, Re, Uu, Rb, Rb, Uu, Uu, Uu, Uu, Rb, Rb, Xu, Xu, Xu, Xu
Xos, Xos, Xos, Xos, Xos, Urb, Urb, Urb, Urb, Urb, Uu, Uu, Rb, Rb, Sm, Sm, Wog, Urb, Uu, Urb, Uu, Uu, Xu, Xu, Uu, Uu, Uu, Ur, Uu, Uu, Uu, Uu, Xu, Xu, Xu, Xu, Xu, Xu, Uu, Uu, Re, Uu, Uu, Rb, Uu, Rb, Re, Uu, Rb, Uu, Uu, Xu, Xu, Xu
Xos, Xos, Xos, Xos, Xos, Urb, Urb, Urb, Urb, Urb, Rb, Rb, Sm, Rb, Wog, Wog, Urb, Urb, Urb, Urb, Uu, Rb, Xu, Uu, Uu, Uu, Uu, Ur, Uu, Uu, Ur, Uu, Xu, Xu, Xu, Xu, Uu, Uu, Rb, Re, Re, Uu, Rb, Uu, Uu, Uu, Uu, Uu, Rb, Uu, Xu, Xu, Xu, Xu
Xos, Xos, Xos, Uu, Xos, Xos, Urb, Urb, Urb, Urb, Urb, Sm, Wog, Wog, Urb, Urb, Urb, Urb, Urb, Urb, Uu, Urb, Xu, Uu, Uu, Uu, Uu, Ur, Ur, Rb, Uu, Uu, Xu, Xu, Xu, Xu, Uu, Rb, Rb, Rb, Uu, Uu, Uu, Uu, Re, Uu, Rb, Uu, Uu, Xu, Xu, Xu, Xu, Xu
Xos, Xos, Urb, Uu, Urb, Xos, Xos, Xos, Xos, Urb, Wog^Bsb\, Wog, Sm, Sm, Urb, Urb, Uu, Urb, Urb, Uu, Rb, Rb, Xu, Xu, Xu, Uu, Uu, Uu, Uu, Rb, Uu, Uu, Xu, Xu, Xu, Xu, Uu, Uu, Uu, Uu, Rb, Re, Re, Re, Rb, Uu, Uu, Uu, Xu, Xu, Xu, Xu, Xu, Xu
Xos, Xos, Urb, Uu, Uu, Xos, Xos, Xos, Xos, Wog, Xos, Rb, Sm, Rb, Rb, Urb, Uu, Uu, Uu, Uu, Xos, Xos, Xu, Xu, Xu, Uu, Uu, Rb, Rb, Uu, Uu, Uu, Xu, Xu, Xu, Xu, Xu, Uu, Uu, Uu, Uu, Rb, Uu, Rb, Uu, Uu, Uu, Xu, Xu, Xu, Xu, Xu, Xu, Xu
Xos, Xos, Xos, Uu, Urb, Uu, Uu, Xos, Xos, Wog, Xos, Xos, Xos, Sm, Sm, Urb, Uu, Urb, Xos, Xos, Xos, Xos, Xu, Xu, Xu, Uu, Rb, Rb, Uu, Uu, Uu, Xu, Xu, Xu, Xu, Xu, Xu, Xu, Xu, Uu, Xu, Uu, Rb, Rb, Uu, Uu, Xu, Xu, Xu, Xu, Xu, Xu, Xu, Xu
Xos, Xos, Xos, Uu, Urb, Uu, Urb, Urb, Wog, Wog, Urb, Urb, Urb, Rb, Sm, Urb, Urb, Urb, Xos, Xos, Xos, Uu, Xu, Xu, Xu, Uu, Uu, Rb, Uu, Uu, Uu, Xu, Xu, Xu, Xu, Xu, Xu, Xu, Xu, Xu, Xu, Uu, Rb, Rb, Uu, Xu, Xu, Xu, Xu, Xu, Xu, Xu, Xu, Xu
Xos, Xos, Xos, Uu, Urb, Urb, Urb, Urb, Wog, Urb, Urb, Urb, Urb, Urb, Urb, Urb, Urb, Xos, Xos, Xos, Xos, Uu, Rr, Xu, Uu, Uu, Uu, Rb, Rb, Uu, Uu, Xu, Xu, Xu, Xu, Xu, Xu, Xu, Uu, Xu, Uu, Uu, Uu, Uu, Uu, Xu, Xu, Xu, Xu, Xu, Xu, Xu, Xu, Xu
Xos, Xos, Xos, Urb, Urb, Urb, Urb, Urb, Wog, Urb, Urb, Urb, Urb, Urb, Uu, Uu, Urb, Xos, Xos, Xos, Rr, Rr, Xu, Xu, Uu, Uu, Ur, Ur, Rb, Rb, Uu, Xu, Xu, Xu, Xu, Xu, Uu, Xu, Uu, Uu, Uu, Re, Uu, Rb, Uu, Xu, Xu, Xu, Xu, Xu, Xu, Xu, Xu, Xu
Xos, Xos, Xos, Urb, Urb, Urb, Urb, Wog, Urb, Urb, Urb, Urb, Urb, Urb, Urb, Urb, Xos, Rr^Pw/, Rr, Rr, Rr, Uu, Xu, Xu, Uu, Uu, Uu, Uu, Rb, Uu, Uu, Uu, Uu, Uu, Uu, Uu, Rb, Uu, Uu, Uu, Ur, Re, Ur, Rb, Rb, Rb, Uu, Xu, Xu, Xu, Xu, Xu, Xu, Xu
Xos, Xos, Xos, Urb, Urb, Urb, Urb, Wog, Urb, Urb, Urb, Urb, Urb, Uu, Xos, Xos, Xos, Rr, Uu, Rr, Uu, Xu, Xu, Xu, Xu, Uu, Uu, Ur, Ur, Rb, Rb, Uu, Rb, Uu, Uu, Uu, Rb, Uu, Rb, Ur, Uu, Re, Re, Ur, Ur, Uu, Ur, Xu, Xu, Xu, Xu, Xu, Xu, Xu
Xos, Xos, Urb, Urb, Urb, Urb, Wog, Wog, Urb, Urb, Urb, Uu, Xos, Xos, Xos, Xos, Rr, Rr, Uu, Uu, Xu, Xu, Xu, Xu, Xu, Uu, Uu, Uu, Uu, Ur, Uu, Ur, Rb, Ur, Rb, Ur, Uu, Ur, Uu, Ur, Uu, Uu, Uu, Rb, Uu, Ur, Re, Uu, Uu, Xu, Xu, Xu, Xu, Xu
Xos, Xos, Wog, Wog, Wog, Wog, Urb, Urb, Urb, Urb, Urb, Xos, Xos, Xos, Xos, Rr, Rr, Rr, Xu, Xu, Xu, Xu, Xu, Xu, Xu, Xu, Xu, Uu, Uu, Uu, Xu, Uu, Uu, Uu, Uu, Uu, Uu, Re, Uu, Uu, Uu, Uu, Uu, Uu, Xu, Uu, Xu, Uu, Uu, Uu, Xu, Xu, Xu, Xu
Wog, Wog, Wog, Wog, Xos, Urb, Xos, Urb, Xos, Xos, Xos, Urb, Xos, Xos, Xos, Rr, Xu, Rr, Xu, Xu, Xu, Xu, Xu, Xu, Xu, Xu, Xu, Xu, Xu, Xu, Xu, Xu, Xu, Xu, Xu, Xu, Xu, Xu, Xu, Xu, Xu, Xu, Xu, Xu, Xu, Xu, Xu, Xu, Xu, Xu, Xu, Xu, Xu, Xu
Wog, Wog, Xos, Xos, Xos, Xos, Xos, Xos, Xos, Xos, Xos, Xos, Xos, Xos, Xu, Xu, Xu, Xu, Xu, Xu, Xu, Xu, Xu, Xu, Xu, Xu, Xu, Xu, Xu, Xu, Xu, Xu, Xu, Xu, Xu, Xu, Xu, Xu, Xu, Xu, Xu, Xu, Xu, Xu, Xu, Xu, Xu, Xu, Xu, Xu, Xu, Xu, Xu, Xu
