Rrc, Rrc, Rrc, Rrc, Rrc, Rrc, Rrc, Rr, Rr, Rr, Rr, Rr, Rr, Rr, Xoc, Xoc, Xoc, Rr, Rr, Rr, Rr, Rr, Rr, Rrc, Rrc, Rrc, Rrc, Rrc
Rrc, Rrc, Rrc, Rrc, Rrc, Rrc, Rr, Rr, Rr, Rr, Rr, Rr, Xoc, Xoc, Ior, Ior, Iwr, Xoc, Xoc, Rr, Rr, Rr, Rr, Rr, Rrc, Rrc, Rrc, Rrc
Rrc, Rrc, Rrc, Rrc, Rrc, Rr, Rr, Rr, Rr, Rr, Rr, Rr, Xoc, Ior, Iwr, Ior, Iwr, Ior, Ior, Xoc, Rr, Rr, Rr, Rr, Rrc, Rrc, Rrc, Rrc
Rrc, Rrc, Rrc, Rrc, Rr, Rr, Rr, Rr, Rr, Rr, Rr, Rr, Xoc, Ior, Xoc, Xoc, Rr^Pw\, Iwr, Ior, Xoc, Rr, Rr, Rr^Ebn, Rr, Rr, Rrc, Rrc, Rrc
Rrc, Rrc, Rrc, Rr, Rr, Rr, Rr, Rr, Rr, Rr, Xoc, Xoc, Xoc, Xoc, Irs, Irs, Irs, Xoc, Xoc, Xoc, Rr, Rr, Rr, Rr, Rr, Rr, Rr, Rrc
Rr, Rrc, Rr, Rr, Rr, Rr, Rr, Rr, Xoc, Xoc, Ior, Ior, Xoc, Irs, Irs, Irs, Irs, Irs, Irs, Xoc^Efs, Rr^Pw\o, Rr, Rr, Rr, Rr, Rr, Rr, Rr
Rr, Rr, Rr, Rr, Rr, Rr, Rr, Xoc, Iwr, Iwr, Iwr, Ior, Xoc, Irs, Irs, Irs^Ebn, Irs, Iwr, Iwr, Irs, Irs, Xoc, Xoc, Rr, Rr, Rr, Rr, Rr
Rr, Rr, Xoc, Rr, Rr, Rr, Rr, Xoc, Ior, Iwr, Xoc, Xoc, Xoc, Irs, Irs, Irs, Irs, Iwr, Iwr, Iwr, Iwr, Irs, Irs, Xoc, Xoc, Rr, Rr, Rr
Xoc, Xoc, Iwr, Xoc, Xoc, Rr, Xoc, Xoc, Xoc, Rr^Pw/, Iwr, Iwr, Iwr, Xoc, Xoc, Irs, Irs, Iwr, Iwr, Iwr, Iwr, Irs, Irs, Irs, Irs, Xoc, Xoc, Rr
Xoc, Iwr, Iwr, Iwr, Iwr, Xoc^Efs, Iwr, Xoc, Iwr, Iwr, Iwr, Iwr, Iwr, Iwr, Iwr, Xoc, Xoc, Irs, Iwr, Iwr, Iwr, Irs, Irs, Irs, Irs, Irs, Xoc, Rr
Xoc, Iwr, Iwr, Iwr, Iwr, Iwr, Iwr, Xoc, Rr^Pw\, Iwr, Iwr, Iwr, Iwr, Iwr, Iwr, Iwr, Xoc, Irs, Iwr, Iwr, Icn, Iwr, Iwr, Irs, Irs, Irs, Xoc, Rr
Rr, Xoc, Xoc, Iwr, Iwr, Iwr, Iwr, Iwr, Iwr, Xoc, Xoc, Iwr, Iwr, Iwr, Iwr, Xoc, Xoc^Efs, Irs, Irs, Iwr, Iwr, Icn, Icn, Iwr, Iwr, Xoc, Xoc, Rr
Rr, Rr, Rr, Xoc, Iwr, Iwr, Iwr, Iwr, Iwr, Iwr, Xoc, Xoc, Iwr, Iwr, Iwr, Xoc, Irs, Irs, Iwr, Iwr, Icn, Icn, Iwr, Icn, Rr^Pw/, Xoc, Ior, Xoc
Rr, Rr, Rr, Xoc, Icn, Iwr, Iwr, Iwr, Iwr, Iwr, Xoc, Irs, Irs, Iwr, Iwr, Iwr, Iwr, Iwr, Iwr, Icn, Iwr, Iwr, Irs, Xoc, Xoc, Iwr, Ior, Ior
Rr, Rr, Rr, Xoc, Icn, Icn, Icn, Iwr, Iwr, Iwr, Iwr, Xoc, Xoc, Irs, Irs, Iwr, Iwr, Iwr, Iwr, Iwr, Irs, Irs, Xoc, Xoc, Xoc, Ior, Iwr, Iwr
Rr, Rr, Rr, Xoc, Icn, Icn, Iwr, Icn, Icn, Iwr, Iwr, Iwr, Iwr, Xoc, Xoc, Irs, Irs, Iwr, Irs, Irs, Xoc, Xoc^Efs, Rr, Rr^Xo, Rr, Xoc, Xoc^Efs, Xoc
Rr, Rr, Rr, Xoc, Icn, Iwr, Icr, Iwr, Icn, Iwr, Iwr, Iwr, Iwr, Iwr, Iwr, Xoc, Xoc, Irs^Ebn, Xoc, Xoc, Rr, Xos, Rr^Pr\o, Rr, Rr, Rr, Xos, Rr
Rr, Rr, Rr, Xoc, Icn^Ebn, Iwr, Iwr, Iwr, Icn, Icn, Icn, Iwr, Iwr, Iwr, Iwr, Iwr^Ebn, Xoc, Xoc, Rr, Rr, Rr, Rr, Rr, Xos, Xos, Rr, Xos, Rr
Rr, Rr, Rr, Xoc, Xoc, Icn, Icn, Icn, Icn, Icn, Icn, Icn, Icn, Iwr, Xoc, Xoc, Rr, Rr, Rr, Rr, Rr, Rr, Rr, Rr, Rr, Xos, Rr, Rr
Rr, Rr, Rr, Rr, Rr, Xoc, Xoc, Icn, Icn, Icn, Icn, Icn, Xoc, Xoc, Rr, Rr, Rr, Rr, Rr, Rr, Rr, Rr, Rr, Rr, Rrc, Rrc, Rrc, Rrc
Rr, Rr, Rr, Rr, Rr, Rr, Rr, Xoc, Xoc, Icn^Ebn, Xoc, Xoc, Rr, Rr, Rr, Rr, Rr, Rr, Rr, Rr, Rr, Rr, Rrc, Rrc, Rrc, Rrc, Rrc, Rrc
