Rr, Rr, Rr, Rrc, Rrc, Rrc, Rrc, Rrc, Rrc, Rrc, Rrc, Rrc
Rr, Rr, Rr, Rr, Rr, Rrc, Rrc, Rrc, Rrc, Rrc, Rrc, Rrc
Xoc, Rr, Rr, Rr, Rr, Rr, Rrc, Rrc, Rrc, Rrc, Rrc, Rrc
Ior, Xoc, Rr, Rr, Rr, Rr, Rrc, Rrc, Rrc, Rrc, Rrc, Rrc
Ior, Xoc, Rr, Rr, Rr^Ebn, Rr, Rr, Rrc, Rrc, Rrc, Rrc, Rrc
Xoc, Xoc, Rr, Rr, Rr, Rr, Rr, Rr, Rr, Rrc, Rrc, Rrc
Irs, Xoc^Efs, Rr^Pw\o, Rr, Rr, Rr, Rr, Rr, Rr, Rr, Rr, Rrc
Iwr, Irs, Irs, Xoc, Xoc, Rr, Rr, Rr, Rr, Rr, Rr, Rr
