border_size=1
usage=map

Uu^Em, Uu^Em, Uu^Em, Uu^Em, Uu, Uu, Uu^Em, Uu^Em, Uu^Em, Uu^Em, Xu, Xu, Uu^Em, Uu, Uu, Uu^Em, Uu^Em, Uu^Edb, Uu^Edb, Uu^Ecf, Xu, Xu, Uu, Uu^Edb, Uu^Edb, Uu^Edb, Xu, Xu, Xu, Xu, Ms^Xm, Ms^Xm, Ms^Xm, Ms^Xm, Ms, Ms^Xm, Ms^Xm
Uu^Em, Uu^Em, Cud, Uu^Edb, Uu^Edb, Uu^Em, Uu^Em, Uu^Em, Uu^Em, Uu^Emf, Xu, Xu, Uu^Em, Uu^Em, Uu^Em, Uu^Em, Uu^Edb, Uu^Edb, Xuc, Xu, Uu^Edb, Uu^Edb, Uu^Edb, Xu, Xu, Xu, Xu, Xu, Xu, Xu, Xu, Ms^Xm, Ms^Xm, Ms^Xm, Mm, Ms^Xm, Ms^Xm
Uu^Em, Cud, Uu^Edt, Cud, Cud, Uu, Xu, Xu, Xu, Xu, Uu^Em, Uu^Emf, Uu^Em, Uu^Em, Uu, Uu, Uu^Ecf, Xu, Xu, Uu^Edb, Uu^Edb, Uu^Edb, 3 Uu^Edb, Uu^Edb, Xu, Xu, Xu, Xu, Xu, Xu, Xu, Ms^Xm, Ms^Xm, Mm, Mm, Mm, Mm
Cud, Cud, Uu^Edt, Uu^Edt, Uu^Edt, Uu, Xu, Xu, Xu, Cud, Uu, Uu^Em, Uu, Uu, Uue, Xu, Uu^Edb, Uu^Edb, Uu^Edb, Xu, Xu, Uu^Edb, Uu^Edb, Uu^Edb, Xu, Xu, Xu, Xu, Xu, Xu, Xu, Ms^Xm, Ms^Xm, Mm, Mm, Mm, Mm
Uu, Uu^Edt, Uu^Edt, Uu^Edt, Uu^Edt, Uu, Uue, Xu, Cud, Cud, Uu^Esd, Uu, Uu, Uu, Uu^Ecf, Xu, Xu, Uu^Edb, Uu^Edt, Uu^Edt, Xu, Uu^Edt, Xu, Xu, Uu^Es, Xu, Uu^Uf, Xu, Xu, Xu, Xu, Xu, Mm^Xm, Mm^Xm, Mm, Mm, Mm
Xu, Uu, Uu, Uu, Uu, Uu, Xu, Xu, Uu, Uu^Esd, Uu, Uu, Uue, Xu, Uu^Edb, Uu^Edb, Uu^Edt, Xu, Xu, Xu, Uu^Edt, Uu^Edt, Xu, Uu^Edb, Uu^Edb, Uu^Edt, Xu, Xu, Xu, Xu, Xu, Xu, Mm^Xm, Mm, Mm, Hh, Hh
Xu, Uu, Uu, Uu, Uu, Xu, Uu, Xu, Uu, Uu, Uu, Uu, Uu^Edb, Xu, Xu, Uu^Edb, Uu^Edt, Uu^Es, Xu, Uu^Edt, Xu, Uu^Ecf, Uu^Edb, Uue, Uu^Edb, Xu, Xu, Xu, Xuc, Xuc, Xu, Mm^Xm, Mm^Xm, Mm, Mm, Hh, Mm
Xu, Uu, Uu, Uu, Uu^Edb, Uu^Edb, Uu^Edb, Uu, Uu^Esd, Uu^Esd, Uue, Xu, Uu^Edt, Uu^Edt, Uu^Edb, Xu, Uu^Edt, Uu^Edt, Uu^Edb, Xu, Uu, Uu, Urb^Edb, Uu^Edb, Xu, Xu, Xu, Xuc, Uu^Emf, Wwg, Wwg, Xu, Xu, Mm^Xm, Mm^Xm, Hh, Hh
Uu, Uu, Uu^Esd, Uu^Edb, Uu^Edb, Uu^Edb, Uu^Edb, Uu^Edb, Uu^Edb, Uu, Uu^Ecf, Xu, Xu, Uu^Edb, Xu, Xu, Xu, Uu^Edb, Uu^Ecf, Xu, Uue, Uu, Urb^Edb, Uu, Xu, Xu, Xuc, Xuc, Uu, Uu^Uf, 1 Uu, Wwg, Wwg, Xu, Mm^Xm, Mm, Mm
Uu, Uu, Uu^Edb, Uu^Edb, Uu^Edb, Uu^Edb, Uu^Edb, Uu^Edb, Uu^Edb, Xu, Uu^Edt, Uu^Edt, Xu, Xu, Uu^Edb, Uu^Es, Uu^Edt, Xu, Uu, Uu, Uu^Edt, Uu^Edt, Urb, Uu, Xuc, Xuc, Xuc, Xuc, Uu^Es, Uu^Edt, Uu^Emf, Wwg, Xu, Xu, Mm^Xm, Mm^Xm, Hh
Uu, Uu, Uu, Uu^Edb, Uu^Edb, Uu^Edb, Uu^Edb, Uu^Edb, Uu^Edb, Xu, Uu^Edb, Uu^Edb, Xu, Uu^Edb, Uu^Edb, Uu^Edt, Uu^Ecf, Xu, Xu, Uu, Uu^Edt, Uu^Edt, Urb^Edt, Uu^Edt, Xuc, Xuc, Xu, Xu, Uh, Uu^Es, Xu, Wwg, Wwg, Xu, Mm^Xm, Hh, Mm
Uu, Uu^Esd, Uu^Esd, Uu, Uu, Uu, Cud, Uu^Edb, Uu, Xu, Xu, Xu, Uu^Em, Xu, Xu, Xu, Uu, Uu, Urb, Urb, Uu, Uu^Edt, Uu^Edb, Urb^Edt, Uu, Xu, Uu^Edt, Uu, Uu^Es, Xu, Uue, Uu^Edb, Wwg, Xu, Mm^Xm, Hh, Wwrg
Uu, Uu, Uu, Uu^Esd, Uu^Esd, Uu, Cud, Uu, Cud, Uu, Uu, Uu^Em, Uu, Uu^Em, Xu, Uu^Edt, Uu^Edt, Uu^Edt, Uu^Edt, Xu, Xu, Uu, Urb^Edt, Urb^Edt, Uu^Edb, Uu, Uu, Uu^Edt, Uu^Es, Xu, Xu, Uu^Es, Uh^Emf, Xu, Mm^Xm, Mm^Xm, Mm^Xm
Uu, Uu, Uu^Edb, Uu^Edb, Uu^Edb, Uu, Uu, Cud, Uu, Cud, Cud, Uu^Edt, Uu, Uu, Uu, Xu, Xu, Uu, Uu, Xu, Xu, Uu, Urb, Uu^Edb, Uu^Edb, Uu^Edb, Uu, Uu, Xu, Xu, Xu, Uu^Es, Xuc, Xuc, Uh, Mm^Xm, Mm
Uu^Edb, Uu, Uu^Edb, Uu, Uu^Edb, Uu^Edb, Uu^Edb, Uu, Uu^Edt, Uu^Edt, Cud, Uu^Edt, Uu, Uu^Edt, Uu, Uu, Uu^Edb, Uu, Uu, Uu^Es, Uu^Esd, Xu, Uu, Uu^Edb, Uu, Uu^Edb, Xu, Xu, Qxu, Uu, Xu, Uu^Es, Xu, Uh, Mm^Xm, Mm, Mm
Uu, Uu^Edb, Uu^Edb, Uu^Edb, Uu^Edb, Uu^Edb, Uu^Edb, Uu^Edb, Uu, Cud, Uu, Uu^Esd, Uu^Esd, Uu^Edt, Uu^Edt, Uu^Edb, Uu^Edb, Uu, Xu, Uu^Es, Xu, Xu, Xu, Uu, Xu, Xu, Uu, Uu, Qxu, Uu, Xu, Uu^Es, Xu, Uh, Xu, Mm^Xm, Mm^Xm
Urb^Edb, Urb^Edb, Urb^Edb, Urb^Edb, Uu^Edb, Uu^Edb, Uu^Edb, Uu^Edb, Uu, Uu^Edt, Uu^Edt, Uu, Uu, Uu, Uu^Edt, Uu, Xu, Xu, Uu^Edt, Xu, Xu, Xu, Urb, Xu, Urb^Edt, Uu^Edt, Qxu^Bs\, Qxu, Ur, Qxu, Qxu, Qxu, Qxu, Xu, Xu, Xu, Mm^Xm
Uu, Uu^Edb, Uu^Edb, Uu^Edb, Uu^Edb, Uu^Edb, Uu, Urb, Uu, Uu, Uu, Uu^Edt, Uu^Edt, Uu^Edt, Uu, Uu, Xu, Uu^Edt, Uu^Edt, Uu^Edt, Uu^Edt, Uu, Xu, Urb, Xu, Qxu, Qxu, Ur, Qxu, Qxu^Bp\, Ur, Qxu, Qxu, Qxu, Mm^Xm, Mm^Xm, Mm
Uu, Uu^Edb, Uu^Edb, Uu^Edt, Uu^Edb, Uu^Edb, Uu, Urb, Uu, Uu, Xu, Xu, Uu, Uu, Xu, Xu, Uh^Es, Uu^Edt, Uu^Edt, Uu^Edt, Xu, Xu, Urb^Es, Xu, Qxu, Qxu, Qxu, Qxu, Qxu, Qxu, Qxu, Ur, Qxu, Mm^Xm, Mm^Xm, Mm, Mm
Uu, Uu, Uu, Uu^Edb, Uu, Uu^Edb, Uu, Urb, Uu, Xu, Xu, Uu, Uu, Uu, Uh^Edt, Uh^Es, Xu, Xu, Uu, Uu, Xu, Urb^Es, Qxu, Qxu^Bs\, Ur, Qxu, Qxu, Qxua, 2 Qxua, Qxu, Qxu, Qxu^Bp|, Xuce, Xu, Xu, Mm, Hh
Uu, Uu, Uu, Uu, Xu, Uu, Urb, Urb, Uu, Xu, Xu, Uu, Uu, Uu, Uu, Xu, Uu, Uu, Uu, Xu, Uu, Urb, Qxu, Qxu, Qxua, Ur, Qxu^Bs\, Qxu, Qxu, Qxu, Qxu, Ur, Xuce, Xu, Xu, Xu, Hh
Uu, Uu, Xu, Xu, Uu^Em, Uu, Uu, Uu, Xu, Uu, Xu, Uu, Uu^Dr, Uu, Uu, Uu, Uu, Uu, Uu, Xu, Uu, Qxu, Qxu, Qxu, Qxua, Qxu, Qxu, Ur, Qxu^Bs\, Qxu, Ur, Ur, Xuc, Xu, Mm^Xm, Hh, Mm
Uu, Uu, Xu, Uu^Uf, Uu, Uu, Uu, Uu^Em, Uu, Xu, Xu, Uh^Edt, Uu, Uu, Uu, Uu^Esd, Uu, Uu, Urb^Es, Xu, Qxu, Qxu^Bs\, Ur, Qxu, Qxu, Qxu, Qxu, Qxu, Xuc, Ur, Xu, Xuce, Mm^Xm, Mm^Xm, Hh, Hh, Mm
Uu, Xu, Xu, Xu, Xu, Urb^Edt, Xu, Uu, Uu, Xu, Xu, Uh^Edt, Xu, Xu, Uu, Uu, Urb^Es, Urb^Es, Qxu^Bs\, Qxu, Qxu, Qxu, Qxu^Bp|, Qxu, Qxu, Qxu, Xue, Xue, Md^Xm, Xuc, Md^Xm, Mm^Xm, Md^Xm, Hh, Gg, Gg, Gg
Uu^Em, Xu, Xu, Xu, Xu, Urb^Edt, Xu, Uu, Uu, Xu, Uu, Xu, Uu, Uu, Uu, Urb^Es, Uu, Uu, Qxua, Ur, Qxu^Bs\, Qxu, Ur, Qxu, Qxu, Qxu, Xue, Xu, Md^Xm, Md^Xm, Md^Xm, Md^Xm, Hh, Hh, Gg, Gg, Gg
Uu^Em, Uu^Em, Uu^Uf, Xu, Uu, Urb^Edb, Uu, Xu, Uu, Uu, Uu^Edt, Uu, Uu, Uu, Uu, Urb, Uue^Em, Uue^Em, Xu, Qxua, Qxua, Ur, Qxu, Qxu, Xue, Xue, Xu, Xu, Xu, Xu, Hh, Hh, Gg, Gg, Gg, Gg, Gg
Uh, Uu^Em, Xu, Xu, Uu, Urb^Edb, Urb^Edt, Uu^Edt, Urb, Urb^Edb, Uu^Edt, Uu^Edt, Uu, Uu, Urb^Es, Urb^Esd, Xu, Xuc, Uue, Xuce, Xu, Qxu^Bs|, Qxu, Qxe, Uue, Uue, Mm^Xm, Mm^Xm, Hh, Hh, Gg, Gg, Gg, Gg, Gg, Gg, Gg
Uu, Uh, Uu, Uu, Uu, Uu^Edt, Xu, Urb^Edt, Xu, Uu, Urb^Es, Uu, Uue^Edp, Urb^Es, Xu, Xu, Xu, Uue, Mm, Uue, Uue, Ur, Qxe, Qxe, Uue, Uue, Mm, Mm, Hh, Gg, Gg, Gg, Gg, Gg, Gg, Gg, Gg
Uu, Uu, Xu, Uu, Xu, Xu, Xuc, Xu, Xu, Xu, Xu, Urb^Es, Xu, Xu, Hh, Xu, Hh, Mm^Xm, Mm, Mm, Uue, Ur, Qxe, Uue, Mm, Mm, Hh, Hh, Gg, Hh, Gg, Gg, Gg, Gg, Gg, Gg, Gg
Xu, Xu, Xu, Xuc, Uh, Xuc, Uh, Xu, Uh, Mm^Xm, Mm^Xm, Xu, Uh, Hh, Hh, Mm, Hh, Hh, Gg, Hh, Rd, Qxua, Uue, Uue, Mm, Hh, Gg, Gg, Gg, Gg, Gg, Gg, Gg, Gg, Gg, Gg, Gg
Xu, Xu, Uh, Uh, Uh, Uh, Mm, Uh, Mm, Mm, Mm, Mm^Xm, Mm, Mm, Hh, Hh, Hh, Hh, Gg, Gg, Rd, Rd, Hh, Hh, Hh, Gg, Gg, Gg, Gg, Gg, Gg, Gg, Gg, Gg, Gg, Gg, Gg
Uh, Uh, Mm, Mm, Mm, Uh, Mm, Mm, Mm, Mm, Mm, Mm, Hh, Hh, Hh, Hh, Gs^Fds, Gs^Fds, Rd, Rd, Gg, Gg, Gg, Hh, Gg, Gg, Gg, Gg, Gg, Gg, Gg, Gg, Gg, Gg, Ww, Gg, Ww
Mm^Xm, Mm, Mm, Mm, Hh, Mm, Hh, Hh, Hh, Hh, Hh, Hh, Gg, Gg, Gg, Gs^Fds, Gs^Fds, Rd, Gg, Gg, Gg, Gg, Gg, Gg, Gg, Gg, Gg, Gg, Gg, Gg, Wwrg, Wwrt, Ww, Ww, Gg, Ww, Gg
Mm^Xm, Mm, Hh, Hh, Hh, Hh, Hh, Hh, Hh, Hh, Gg, Gg, Gg, Gg, Gg, Gg, Gg, Rd, Gg, Gg, Gg, Gg, Hh, Hh, Hh, Hh, Gg, Gg, Wwrt, Wwrg, Wwr, Wwrt, Gg, Gg, Gg, Gg, Gg
